production_order_id;material_id;tube_line_id;posting_date;body_quantity;prod_quantity;scrap_quantity;prod_h
20042506;271626;0;03.01.2023 00:00;112064;91056;21008;6.2
20042507;271703;0;03.01.2023 00:00;302022;274926;27096;16.9
20042646;278885;0;04.01.2023 00:00;82727;30781;51946;1.9
20042647;278888;0;05.01.2023 00:00;119628;92343;27285;7.2
20042645;269751;0;05.01.2023 00:00;88688;61563;27125;3.8
20042644;269748;0;05.01.2023 00:00;38706;30780;7926;1.9
20042726;;0;05.01.2023 00:00;0;0;0;0.0
20042729;278891;0;06.01.2023 00:00;51894;25654;26240;2.2
20042728;269750;0;06.01.2023 00:00;160247;102602;57645;7.3
20042727;281496;0;07.01.2023 00:00;177492;140418;37074;9.6
20043082;266175;0;16.01.2023 00:00;296131;253136;42995;15.6
20043440;279122;0;16.01.2023 00:00;113084;76953;36131;5.3
20043088;;0;17.01.2023 00:00;0;0;0;0.0
20043439;269639;0;17.01.2023 00:00;96793;50392;46401;3.5
20043438;269633;0;18.01.2023 00:00;52950;50388;2562;3.5
20043436;268888;0;18.01.2023 00:00;125041;100778;24263;6.9
20043437;269632;0;18.01.2023 00:00;180601;150280;30321;9.2
20043441;279123;0;19.01.2023 00:00;388860;307808;81052;20.6
20043442;279124;0;20.01.2023 00:00;55769;30780;24989;2.0
20043578;279939;0;20.01.2023 00:00;387247;318245;69002;20.1
20043636;282813;0;23.01.2023 00:00;860139;667426;192713;44.9
20043793;263731;0;26.01.2023 00:00;962317;782050;180267;48.9
20043883;274674;0;31.01.2023 00:00;193825;100780;93045;8.8
20043884;274676;0;01.02.2023 00:00;134013;110503;23510;7.6
20044315;274679;0;01.02.2023 00:00;319302;250174;69128;17.6
20044023;274677;0;02.02.2023 00:00;349263;300564;48699;20.1
20044312;282982;0;03.02.2023 00:00;1768;1768;0;2.8
20044313;282980;0;04.02.2023 00:00;1768;1768;0;0.9
20044314;282985;0;04.02.2023 00:00;0;1768;-1768;1.5
20044632;269752;0;04.02.2023 00:00;607550;492486;115064;31.5
20044741;282895;0;16.02.2023 00:00;884;884;0;5.2
20044905;283194;0;16.02.2023 00:00;33574;19449;14125;1.3
20044447;282894;0;16.02.2023 00:00;884;884;0;3.0
20044904;271624;0;17.02.2023 00:00;464689;365095;99594;23.9
20044908;271266;0;02.03.2023 00:00;158816;73474;85342;7.7
20044906;265341;0;03.03.2023 00:00;155057;110785;44272;7.2
20044907;265342;0;03.03.2023 00:00;308638;257152;51486;17.2
20045857;265342;0;07.03.2023 00:00;300407;257726;42681;18.2
20045861;265342;0;08.03.2023 00:00;279366;257161;22205;16.3
20046000;269754;0;09.03.2023 00:00;35941;20524;15417;1.7
20046003;269753;0;09.03.2023 00:00;181608;128763;52845;8.9
20046002;279122;0;10.03.2023 00:00;60652;51302;9350;3.7
20046001;269755;0;10.03.2023 00:00;73153;61560;11593;3.8
20046069;272360;0;10.03.2023 00:00;9133;3327;5806;0.3
20046070;272361;0;10.03.2023 00:00;11802;3327;8475;0.3
20046487;280917;0;10.03.2023 00:00;58212;26882;31330;1.5
20046074;274789;0;12.03.2023 00:00;1414159;1290257;123902;80.0
20046180;;0;17.03.2023 00:00;0;0;0;0.0
20046071;283182;0;17.03.2023 00:00;7000;2652;4348;0.5
20046489;283468;0;17.03.2023 00:00;884;884;0;7.0
20046488;282947;0;17.03.2023 00:00;25636;25636;0;9.2
20047392;279123;0;18.03.2023 00:00;400774;338582;62192;22.0
20047065;269751;0;19.03.2023 00:00;78413;61560;16853;4.1
20047189;269748;0;19.03.2023 00:00;40000;30780;9220;2.2
20047225;271703;0;03.04.2023 00:00;329343;270509;58834;19.2
20047226;283803;0;03.04.2023 00:00;886;886;0;0.1
20047473;271701;0;05.04.2023 00:00;313638;270506;43132;17.6
20047472;271698;0;06.04.2023 00:00;122524;92820;29704;5.7
20047895;277543;0;06.04.2023 00:00;63500;25636;37864;2.5
20047232;;0;11.04.2023 00:00;0;0;0;0.0
20047891;280444;0;11.04.2023 00:00;133424;110213;23211;7.7
20048188;265342;0;12.04.2023 00:00;280471;257157;23314;16.1
20048136;268647;0;12.04.2023 00:00;42000;36736;5264;2.8
20048264;265341;0;13.04.2023 00:00;125462;110210;15252;6.7
20048263;265341;0;13.04.2023 00:00;120078;110215;9863;7.0
20047892;283805;0;13.04.2023 00:00;475;475;0;1.9
20048262;;0;14.04.2023 00:00;0;0;0;0.0
20048397;269752;0;14.04.2023 00:00;1369120;1077313;291807;71.9
20049028;283046;0;20.04.2023 00:00;4420;4420;0;0.3
20049027;283972;0;20.04.2023 00:00;3536;3536;0;2.0
20048774;283638;0;21.04.2023 00:00;2654;2654;0;8.5
20048654;280200;0;21.04.2023 00:00;37858;11492;26366;0.8
20048703;;0;21.04.2023 00:00;0;0;0;0.0
20048708;275684;0;21.04.2023 00:00;50593;26880;23713;1.8
20048704;271283;0;22.04.2023 00:00;34862;26880;7982;1.8
20048709;230137;0;22.04.2023 00:00;30649;26883;3766;1.7
20048981;263774;0;02.05.2023 00:00;183722;161280;22442;10.4
20048706;271285;0;02.05.2023 00:00;76240;53764;22476;3.7
20048707;272318;0;02.05.2023 00:00;68532;53762;14770;3.6
20048705;271284;0;03.05.2023 00:00;27160;26880;280;1.7
20048710;272320;0;03.05.2023 00:00;57241;53762;3479;3.4
20049090;271400;0;03.05.2023 00:00;55000;36288;18712;2.4
20049282;282978;0;03.05.2023 00:00;55277;41331;13946;2.7
20049278;271399;0;03.05.2023 00:00;84220;72576;11644;4.7
20049303;257703;0;04.05.2023 00:00;177966;152210;25756;9.6
20049304;281590;0;04.05.2023 00:00;301058;282242;18816;17.7
20049470;241454;0;05.05.2023 00:00;167890;144806;23084;9.0
20049471;244458;0;06.05.2023 00:00;269789;245730;24059;15.6
20049562;252902;0;08.05.2023 00:00;213017;175520;37497;11.4
20050065;234097;0;09.05.2023 00:00;129319;104217;25102;6.5
20049563;257817;0;10.05.2023 00:00;48780;26328;22452;1.9
20049580;235285;0;10.05.2023 00:00;80795;70208;10587;4.6
20049579;234096;0;10.05.2023 00:00;56810;52658;4152;3.2
20050064;269754;0;11.05.2023 00:00;47607;20522;27085;1.3
20049720;269755;0;12.05.2023 00:00;86650;61560;25090;4.3
20050155;282015;0;12.05.2023 00:00;53145;35107;18038;2.2
20050067;278892;0;12.05.2023 00:00;24606;20520;4086;1.3
20050158;284015;0;12.05.2023 00:00;70911;52656;18255;3.3
20050156;282023;0;13.05.2023 00:00;69900;105312;-35412;6.6
20050288;284019;0;15.05.2023 00:00;68153;52658;15495;3.2
20050188;284097;0;15.05.2023 00:00;142462;94863;47599;6.3
20050166;284012;0;16.05.2023 00:00;70745;63242;7503;4.1
20050448;284047;0;16.05.2023 00:00;336240;298384;37856;18.9
20050289;284095;0;16.05.2023 00:00;46148;31620;14528;2.0
20050345;269753;0;22.05.2023 00:00;176887;128252;48635;8.2
20050066;269750;0;22.05.2023 00:00;160943;128250;32693;8.1
20050673;284306;0;23.05.2023 00:00;2054;2054;0;1.1
20050108;;0;23.05.2023 00:00;0;0;0;0.0
20050113;269749;0;23.05.2023 00:00;609732;492480;117252;31.2
20050387;279248;0;25.05.2023 00:00;305872;246243;59629;15.5
20050429;269748;0;26.05.2023 00:00;90081;61561;28520;3.8
20050719;269748;0;26.05.2023 00:00;40633;30780;9853;1.8
20050720;272357;0;27.05.2023 00:00;29321;15028;14293;1.0
20050114;284092;0;05.06.2023 00:00;884;884;0;2.1
20050430;271700;0;05.06.2023 00:00;245507;181222;64285;11.8
20050721;272358;0;05.06.2023 00:00;10000;7956;2044;1.2
20050722;283898;0;06.06.2023 00:00;428570;362442;66128;22.7
20050718;230491;0;07.06.2023 00:00;36714;15029;21685;1.0
20050723;284094;0;07.06.2023 00:00;59113;35107;24006;2.2
20050717;;0;07.06.2023 00:00;0;0;0;0.0
20051366;284276;0;08.06.2023 00:00;4592;4592;0;4.0
20051030;269750;0;08.06.2023 00:00;113071;76952;36119;5.4
20050828;272359;0;08.06.2023 00:00;5225;5225;0;5.2
20051657;;0;14.06.2023 00:00;0;0;0;0.0
20051659;283898;0;14.06.2023 00:00;338787;269620;69167;17.8
20051658;271626;0;16.06.2023 00:00;109311;92820;16491;6.5
20051796;284371;0;16.06.2023 00:00;101662;60112;41550;4.1
20051795;284370;0;22.06.2023 00:00;222954;150280;72674;11.6
20051794;284369;0;22.06.2023 00:00;184607;150284;34323;10.2
20052285;284603;0;23.06.2023 00:00;45754;33592;12162;2.1
20051793;284299;0;25.06.2023 00:00;142483;84866;57617;5.3
20052396;271699;0;08.07.2023 00:00;134659;90173;44486;5.7
20052395;271698;0;10.07.2023 00:00;208612;180336;28276;11.2
20052397;271703;0;11.07.2023 00:00;293751;270506;23245;16.9
20052233;269749;0;11.07.2023 00:00;580975;492482;88493;30.6
20052564;269752;0;13.07.2023 00:00;668136;584822;83314;35.8
20052912;269751;0;17.07.2023 00:00;129818;92340;37478;5.7
20052911;269748;0;17.07.2023 00:00;36800;30780;6020;1.9
20053320;284460;0;17.07.2023 00:00;54874;32709;22165;2.0
20052795;;0;18.07.2023 00:00;0;0;0;0.0
20052917;269755;0;18.07.2023 00:00;60646;41041;19605;2.5
20053321;284462;0;18.07.2023 00:00;38711;30719;7992;2.0
20052914;281892;0;18.07.2023 00:00;2196;2196;0;1.4
20053040;266577;0;18.07.2023 00:00;59960;36736;23224;2.5
20053039;265341;0;19.07.2023 00:00;135942;110210;25732;6.8
20053060;265342;0;19.07.2023 00:00;309220;257152;52068;16.6
20053295;265342;0;20.07.2023 00:00;321576;257152;64424;16.8
20053414;283329;0;21.07.2023 00:00;181948;146944;35004;9.4
20053417;282811;0;09.08.2023 00:00;176457;146946;29511;9.1
20054216;268647;0;10.08.2023 00:00;52865;36739;16126;2.4
20054215;266577;0;10.08.2023 00:00;41002;36738;4264;2.5
20054214;265341;0;10.08.2023 00:00;119890;110210;9680;7.0
20053613;268970;0;10.08.2023 00:00;74070;60273;13797;3.8
20053615;276274;0;19.08.2023 00:00;43071;40182;2889;2.5
20054229;266442;0;19.08.2023 00:00;82832;60270;22562;4.2
20054228;266441;0;21.08.2023 00:00;72391;60272;12119;3.8
20053616;278892;0;21.08.2023 00:00;60733;30780;29953;2.9
20053614;269754;0;22.08.2023 00:00;33619;30780;2839;2.4
20053426;;0;23.08.2023 00:00;0;0;0;0.0
20054921;285079;0;23.08.2023 00:00;3;3;0;1.5
20054108;284846;0;23.08.2023 00:00;164080;106080;58000;7.3
20054389;268971;0;24.08.2023 00:00;308888;250172;58716;15.4
20054390;268974;0;01.09.2023 00:00;66741;50388;16353;3.2
20054844;271628;0;01.09.2023 00:00;125100;92820;32280;6.0
20054391;284851;0;02.09.2023 00:00;12538;3539;8999;3.8
20054843;269748;0;04.09.2023 00:00;64341;30783;33558;2.0
20054845;279123;0;04.09.2023 00:00;468470;307800;160670;19.7
20054960;;0;06.09.2023 00:00;0;0;0;0.0
20055015;279249;0;06.09.2023 00:00;154100;102604;51496;7.6
20055016;269750;0;12.09.2023 00:00;168780;123120;45660;8.4
20055017;269753;0;19.09.2023 00:00;149417;127739;21678;8.8
20055018;269755;0;20.09.2023 00:00;51059;41041;10018;2.8
20055268;284462;0;20.09.2023 00:00;19813;10970;8843;0.7
20055295;284460;0;20.09.2023 00:00;179995;130834;49161;9.5
20055019;;0;20.09.2023 00:00;0;0;0;0.0
20054846;279248;0;21.09.2023 00:00;608622;492482;116140;31.4
20054848;269749;0;25.09.2023 00:00;707284;615604;91680;37.9
20055920;271702;0;27.09.2023 00:00;145065;92823;52242;6.6
20055980;263731;0;28.09.2023 00:00;1593398;1340646;252752;85.8
20056223;275509;0;28.09.2023 00:00;0;0;0;0.0
20056839;271626;0;15.10.2023 00:00;125502;92822;32680;5.7
20056838;266440;0;16.10.2023 00:00;85191;60112;25079;3.7
20056963;266439;0;16.10.2023 00:00;131214;100781;30433;7.8
20056962;266438;0;17.10.2023 00:00;229894;199786;30108;14.1
20056631;272357;0;17.10.2023 00:00;6274;2654;3620;0.2
20056966;284092;0;18.10.2023 00:00;1768;1768;0;0.5
20056964;283468;0;18.10.2023 00:00;1770;1770;0;0.2
20056629;;0;18.10.2023 00:00;0;0;0;0.0
20056633;282811;0;18.10.2023 00:00;171085;110212;60873;8.1
20057115;282811;0;19.10.2023 00:00;175583;109060;66523;8.9
20057114;265341;0;19.10.2023 00:00;125068;110208;14860;7.5
20056632;272361;0;20.10.2023 00:00;12420;2375;10045;0.5
20057763;269750;0;30.10.2023 00:00;273994;205200;68794;14.8
20057244;278889;0;31.10.2023 00:00;37004;25654;11350;2.0
20056630;;0;31.10.2023 00:00;0;0;0;0.0
20057372;285480;0;31.10.2023 00:00;59373;51302;8071;3.7
20057388;269748;0;31.10.2023 00:00;112000;61560;50440;4.3
20057617;285478;0;01.11.2023 00:00;66141;61562;4579;4.0
20057616;279123;0;01.11.2023 00:00;147889;107730;40159;7.3
20057615;269749;0;01.11.2023 00:00;619420;492480;126940;31.4
20057714;285479;0;03.11.2023 00:00;224874;153900;70974;10.3
20058343;269749;0;13.11.2023 00:00;608058;492488;115570;31.4
20057953;280510;0;15.11.2023 00:00;48292;25637;22655;1.6
20057713;285477;0;15.11.2023 00:00;168030;90171;77859;5.9
20057712;284299;0;16.11.2023 00:00;113794;75142;38652;4.9
20058249;274674;0;16.11.2023 00:00;189479;150285;39194;9.4
20058250;274677;0;17.11.2023 00:00;175171;150282;24889;8.9
20058903;271624;0;02.12.2023 00:00;406798;360676;46122;22.7
20058928;271699;0;04.12.2023 00:00;98419;90168;8251;5.6
20059043;271700;0;05.12.2023 00:00;115725;90170;25555;5.7
20059044;271703;0;05.12.2023 00:00;411486;360681;50805;24.8
20059214;269752;0;06.12.2023 00:00;1116432;894681;221751;58.8
20059333;269751;0;13.12.2023 00:00;92813;61562;31251;3.8
20059347;272357;0;13.12.2023 00:00;24433;8843;15590;0.7
20059431;266990;0;15.12.2023 00:00;186058;157970;28088;10.1
20059430;266990;0;16.12.2023 00:00;217797;193074;24723;12.6
20059429;284106;0;18.12.2023 00:00;192792;146951;45841;10.2
20059427;;0;19.12.2023 00:00;0;0;0;0.0
20059485;;0;19.12.2023 00:00;0;0;0;0.0
20059616;284370;0;19.12.2023 00:00;72178;30058;42120;2.3
20059615;284369;0;19.12.2023 00:00;70385;60118;10267;3.9
20059346;284369;0;20.12.2023 00:00;181924;150284;31640;9.5
20059617;284370;0;20.12.2023 00:00;183390;150283;33107;9.3
20059488;280430;0;21.12.2023 00:00;467300;367365;99935;23.7
20059781;;0;21.12.2023 00:00;0;0;0;0.0
20059872;282811;0;22.12.2023 00:00;77583;73477;4106;4.7
20059931;285830;0;08.01.2024 00:00;40989;36738;4251;2.8
20059858;269753;0;08.01.2024 00:00;189875;128252;61623;8.8
20059864;269750;0;08.01.2024 00:00;94789;76950;17839;5.8
20059859;269754;0;09.01.2024 00:00;96701;51303;45398;3.6
20059981;269749;0;15.01.2024 00:00;1039275;893137;146138;53.8
20058936;285967;0;15.01.2024 00:00;0;0;0;0.0
20060025;269752;0;18.01.2024 00:00;978253;861849;116404;53.3
20060491;274234;0;23.01.2024 00:00;3538;3538;0;5.2
20060471;269755;0;23.01.2024 00:00;60298;41042;19256;2.7
20060466;;0;23.01.2024 00:00;0;0;0;0.0
20060490;274248;0;24.01.2024 00:00;1902;1902;0;5.6
20060645;284106;0;24.01.2024 00:00;119272;73475;45797;4.8
20060644;282811;0;25.01.2024 00:00;62107;73472;-11365;4.4
20060894;;0;26.01.2024 00:00;0;0;0;0.0
20060895;271626;0;26.01.2024 00:00;145231;90170;55061;6.7
20060896;271628;0;26.01.2024 00:00;108318;90170;18148;5.9
20060897;271702;0;27.01.2024 00:00;214171;182988;31183;11.5
20061611;;0;20.02.2024 00:00;0;0;0;0.0
20061621;271361;0;20.02.2024 00:00;26251;9875;16376;0.8
20061622;271362;0;20.02.2024 00:00;25969;9875;16094;0.7
20061619;271359;0;21.02.2024 00:00;15668;9875;5793;0.8
20061620;271360;0;21.02.2024 00:00;11500;9873;1627;0.7
20061618;271358;0;21.02.2024 00:00;18260;9875;8385;0.8
20061615;271355;0;21.02.2024 00:00;12300;10970;1330;0.8
20061616;271356;0;21.02.2024 00:00;17000;15358;1642;1.1
20061617;271357;0;21.02.2024 00:00;23709;15360;8349;1.2
20061613;279122;0;21.02.2024 00:00;99207;76952;22255;5.2
20061612;;0;22.02.2024 00:00;0;0;0;0.0
20062117;286044;0;22.02.2024 00:00;2653;2653;0;5.4
20062106;283898;0;22.02.2024 00:00;313021;270507;42514;16.4
20062103;266438;0;23.02.2024 00:00;210032;175034;34998;11.4
20062104;269751;0;24.02.2024 00:00;145265;92343;52922;6.3
20062373;269748;0;26.02.2024 00:00;77022;61562;15460;3.8
20062105;279123;0;26.02.2024 00:00;220855;184686;36169;12.0
20062107;284299;0;27.02.2024 00:00;107362;75140;32222;5.5
20062400;286491;0;28.02.2024 00:00;2005;2005;0;9.8
20063033;269752;0;15.03.2024 00:00;1055436;892620;162816;54.9
20063291;282982;0;20.03.2024 00:00;26051;15916;10135;0.5
20062968;281127;0;20.03.2024 00:00;4020;4020;0;2.7
20063292;282985;0;20.03.2024 00:00;11439;5306;6133;0.4
20063017;;0;20.03.2024 00:00;0;0;0;0.0
20062967;281124;0;20.03.2024 00:00;19584;19584;0;3.4
20062971;286753;0;20.03.2024 00:00;10639;3328;7311;0.6
20062969;269753;0;21.03.2024 00:00;160458;128252;32206;8.5
20062970;269755;0;21.03.2024 00:00;72195;61563;10632;4.4
20063896;286102;0;02.04.2024 00:00;37455;20520;16935;1.6
20064218;269750;0;02.04.2024 00:00;141687;102602;39085;7.3
20064219;278892;0;02.04.2024 00:00;30280;20520;9760;1.6
20063897;286103;0;02.04.2024 00:00;30740;20520;10220;1.6
20064217;286101;0;03.04.2024 00:00;37578;25650;11928;2.0
20064216;285480;0;05.04.2024 00:00;92795;53873;38922;4.0
20063906;;0;24.04.2024 00:00;0;0;0;0.0
20063891;286099;0;24.04.2024 00:00;63900;30780;33120;2.3
20063892;286100;0;24.04.2024 00:00;93298;61560;31738;3.9
20064387;285479;0;24.04.2024 00:00;170986;153902;17084;10.5
20065429;274869;0;25.04.2024 00:00;40949;40949;0;12.3
20064567;274869;0;25.04.2024 00:00;349718;315593;34125;20.7
20064604;286044;0;27.04.2024 00:00;21100;21100;0;7.0
20064375;284846;0;29.04.2024 00:00;120997;106083;14914;7.8
20064374;284371;0;29.04.2024 00:00;57548;30940;26608;2.5
20064862;286969;0;30.04.2024 00:00;3469;3469;0;3.7
20064582;274789;0;30.04.2024 00:00;1473099;1290255;182844;80.0
20065292;;0;30.04.2024 00:00;0;0;0;0.0
20065114;284372;0;06.05.2024 00:00;49010;25177;23833;2.1
20065111;286970;0;07.05.2024 00:00;4987;4987;0;2.3
20065938;271357;0;25.05.2024 00:00;116395;91053;25342;6.1
20065937;271356;0;27.05.2024 00:00;110638;85566;25072;6.0
20065955;271355;0;28.05.2024 00:00;54829;46076;8753;3.8
20065957;271359;0;28.05.2024 00:00;41858;25233;16625;1.5
20065958;271360;0;28.05.2024 00:00;23695;20843;2852;1.4
20065959;271361;0;28.05.2024 00:00;26466;20845;5621;1.4
20065956;271358;0;28.05.2024 00:00;30313;20845;9468;1.8
20065960;271362;0;28.05.2024 00:00;17200;15358;1842;1.0
20066056;262246;0;28.05.2024 00:00;373026;302105;70921;19.1
20066040;279978;0;30.05.2024 00:00;141623;113836;27787;7.8
20066039;279977;0;30.05.2024 00:00;127040;113837;13203;7.3
20066137;269753;0;31.05.2024 00:00;163900;128250;35650;8.9
20066138;269755;0;31.05.2024 00:00;66087;41042;25045;2.9
20066136;269754;0;01.06.2024 00:00;65380;41042;24338;2.7
20066139;286871;0;03.06.2024 00:00;89274;55445;33829;3.8
20066377;274789;0;03.06.2024 00:00;1464024;1290808;173216;80.6
20066378;;0;08.06.2024 00:00;0;0;0;0.0
20066530;287443;0;10.06.2024 00:00;31837;31837;0;9.5
20066410;287690;0;10.06.2024 00:00;7526;7526;0;5.4
20066532;284369;0;10.06.2024 00:00;186236;100778;85458;8.3
20066534;287325;0;11.06.2024 00:00;10893;10893;0;4.1
20066619;285477;0;11.06.2024 00:00;121413;90168;31245;6.0
20066660;271624;0;12.06.2024 00:00;320871;282882;37989;17.3
20066533;287136;0;13.06.2024 00:00;40745;43397;-2652;7.4
20066531;269751;0;13.06.2024 00:00;106468;61560;44908;4.5
20066782;285478;0;14.06.2024 00:00;79820;61562;18258;4.4
20066771;269749;0;14.06.2024 00:00;1107702;831061;276641;55.2
20066920;280514;0;20.06.2024 00:00;48675;25638;23037;1.6
20066940;274148;0;21.06.2024 00:00;166030;100782;65248;6.4
20066941;274649;0;21.06.2024 00:00;137337;100780;36557;6.7
20066939;;0;22.06.2024 00:00;0;0;0;0.0
20067023;274653;0;22.06.2024 00:00;80363;50353;30010;3.7
20067048;257817;0;24.06.2024 00:00;38690;21943;16747;1.5
20067108;258364;0;24.06.2024 00:00;46050;30716;15334;2.0
20067109;275207;0;24.06.2024 00:00;210404;201850;8554;12.7
20067107;234742;0;25.06.2024 00:00;260922;219402;41520;14.6
20067250;235546;0;26.06.2024 00:00;48700;43880;4820;2.8
20067313;234098;0;26.06.2024 00:00;87202;71307;15895;4.6
20067324;274789;0;26.06.2024 00:00;1397159;1290250;106909;78.6
20068153;274156;0;02.07.2024 00:00;43597;15501;28096;1.2
20068154;274157;0;03.07.2024 00:00;41400;35014;6386;2.5
20068204;;0;03.07.2024 00:00;0;0;0;0.0
20068313;269748;0;03.07.2024 00:00;109446;61560;47886;4.4
20068316;279247;0;04.07.2024 00:00;42933;30782;12151;2.4
20068314;271700;0;05.07.2024 00:00;199601;180340;19261;11.7
20068315;271704;0;09.07.2024 00:00;121689;92824;28865;6.2
20068450;279247;0;11.07.2024 00:00;71503;30782;40721;1.9
20068803;288341;0;30.07.2024 00:00;13800;13800;0;8.0
20069378;288617;0;08.08.2024 00:00;34371;17714;16657;3.8
20069380;288621;0;09.08.2024 00:00;34035;38455;-4420;4.7
20069379;288619;0;09.08.2024 00:00;20500;20500;0;3.3
20068451;279248;0;09.08.2024 00:00;644290;492483;151807;33.9
20069372;266175;0;12.08.2024 00:00;385668;284714;100954;20.1
20069022;;0;12.08.2024 00:00;0;0;0;0.0
20069374;272318;0;13.08.2024 00:00;38500;26880;11620;1.7
20069373;271285;0;14.08.2024 00:00;67157;53762;13395;3.4
20069375;272320;0;14.08.2024 00:00;44681;26882;17799;1.8
20069371;263774;0;14.08.2024 00:00;65440;53763;11677;3.2
20069370;224778;0;14.08.2024 00:00;30215;26882;3333;1.7
20069377;288468;0;14.08.2024 00:00;27321;26880;441;1.9
20069376;288220;0;14.08.2024 00:00;30014;26882;3132;2.0
20068833;286101;0;15.08.2024 00:00;41484;25655;15829;1.6
20069412;279249;0;16.08.2024 00:00;90990;76952;14038;5.1
20069414;269753;0;16.08.2024 00:00;145349;128255;17094;9.0
20069413;269750;0;17.08.2024 00:00;136880;128765;8115;9.1
20069415;272359;0;19.08.2024 00:00;10929;1425;9504;0.2
20069696;274789;0;19.08.2024 00:00;1462459;1290244;172215;81.9
20069416;272360;0;19.08.2024 00:00;11319;952;10367;0.1
20069417;272361;0;19.08.2024 00:00;7491;2377;5114;0.2
20070294;;0;27.08.2024 00:00;0;0;0;0.0
20070291;288787;0;27.08.2024 00:00;40413;40413;0;4.0
20070295;;0;09.09.2024 00:00;0;0;0;0.0
20070601;269755;0;09.09.2024 00:00;94732;61563;33169;5.2
20070594;279249;0;10.09.2024 00:00;100630;76952;23678;5.1
20070658;;0;10.09.2024 00:00;0;0;0;0.0
20070660;286099;0;10.09.2024 00:00;59283;30780;28503;2.3
20070659;269751;0;10.09.2024 00:00;81413;61562;19851;3.8
20070663;288515;0;11.09.2024 00:00;128411;92825;35586;6.5
20070662;288513;0;12.09.2024 00:00;112282;90170;22112;5.6
20070720;288514;0;12.09.2024 00:00;93759;90172;3587;5.7
20070721;288716;0;12.09.2024 00:00;128728;102546;26182;6.7
20070754;288563;0;13.09.2024 00:00;143275;111722;31553;7.2
20070837;288378;0;13.09.2024 00:00;731887;643504;88383;39.7
20070839;;0;17.09.2024 00:00;0;0;0;0.0
20070897;280430;0;17.09.2024 00:00;424758;367362;57396;22.3
20070981;280430;0;19.09.2024 00:00;1113367;991882;121485;61.5
20071411;265341;0;30.09.2024 00:00;378225;330624;47601;20.3
20072193;;0;25.10.2024 00:00;0;0;0;0.0
20071921;271698;0;25.10.2024 00:00;178015;94591;83424;6.3
20071922;271701;0;29.10.2024 00:00;226879;181227;45652;11.7
20072182;283898;0;30.10.2024 00:00;468234;360676;107558;22.8
20072181;271626;0;31.10.2024 00:00;99162;91941;7221;5.8
20072619;268973;0;01.11.2024 00:00;46875;30056;16819;2.0
20072618;268972;0;01.11.2024 00:00;75242;60114;15128;4.3
20072617;268971;0;01.11.2024 00:00;365894;300565;65329;19.5
20072621;284092;0;03.11.2024 00:00;62913;62913;0;10.2
20072620;283468;0;03.11.2024 00:00;31124;39546;-8422;5.2
20072622;;0;03.11.2024 00:00;0;0;0;0.0
20072699;268968;0;03.11.2024 00:00;71542;30426;41116;2.2
20072700;268970;0;04.11.2024 00:00;39600;30423;9177;2.1
20072731;264722;0;04.11.2024 00:00;153237;110211;43026;6.8
20072814;288320;0;05.11.2024 00:00;159707;110214;49493;6.8
20073398;264722;0;05.11.2024 00:00;104962;110210;-5248;5.9
20072812;284106;0;05.11.2024 00:00;79092;73474;5618;4.5
20072884;269750;0;07.11.2024 00:00;218448;153902;64546;11.4
20072810;279249;0;08.11.2024 00:00;93705;76952;16753;5.1
20072883;269754;0;08.11.2024 00:00;42804;20524;22280;1.9
20072937;278893;0;08.11.2024 00:00;33000;20520;12480;1.5
20072938;286102;0;08.11.2024 00:00;32890;20522;12368;1.4
20072936;;0;09.11.2024 00:00;0;0;0;0.0
20072935;269749;0;09.11.2024 00:00;1143756;861853;281903;60.6
20073005;269751;0;13.11.2024 00:00;112838;61650;51188;4.1
20073004;269748;0;14.11.2024 00:00;45200;30780;14420;2.3
20042712;275207;1;09.01.2023 00:00;67694;54854;12840;3.3
20043194;258364;1;09.01.2023 00:00;151978;131643;20335;8.2
20042711;237297;1;10.01.2023 00:00;53440;50462;2978;3.2
20042896;274789;1;10.01.2023 00:00;1413015;1290255;122760;79.7
20042973;254049;1;10.01.2023 00:00;43752;39492;4260;2.5
20043443;274789;1;22.01.2023 00:00;1372908;1290242;82666;82.1
20043795;265724;1;26.01.2023 00:00;66592;25234;41358;2.3
20043792;234742;1;26.01.2023 00:00;172517;131642;40875;8.8
20043906;282913;1;27.01.2023 00:00;19748;19748;0;2.5
20043794;275207;1;27.01.2023 00:00;248121;219402;28719;13.9
20043796;266990;1;28.01.2023 00:00;284906;250119;34787;16.3
20044119;282978;1;06.02.2023 00:00;63735;27552;36183;3.7
20044118;282784;1;06.02.2023 00:00;126731;79217;47514;5.9
20044122;271287;1;06.02.2023 00:00;29991;26882;3109;1.6
20044255;224778;1;07.02.2023 00:00;61854;53760;8094;3.1
20044121;271286;1;07.02.2023 00:00;28002;26882;1120;1.6
20044257;263774;1;07.02.2023 00:00;87650;80644;7006;5.2
20044256;227750;1;07.02.2023 00:00;35427;26880;8547;1.6
20044260;272319;1;07.02.2023 00:00;62082;53762;8320;3.4
20044120;271283;1;08.02.2023 00:00;60290;53762;6528;3.2
20044397;282902;1;08.02.2023 00:00;17000;13164;3836;4.2
20044401;282907;1;08.02.2023 00:00;17000;13164;3836;1.1
20044400;282906;1;08.02.2023 00:00;6464;13164;-6700;1.0
20044396;282901;1;08.02.2023 00:00;36124;13165;22959;1.7
20044398;282903;1;08.02.2023 00:00;20000;14261;5739;1.0
20044404;282919;1;09.02.2023 00:00;19777;9873;9904;1.5
20044403;282916;1;09.02.2023 00:00;17900;10970;6930;1.4
20044449;282904;1;09.02.2023 00:00;15000;10970;4030;1.0
20044402;282914;1;09.02.2023 00:00;16000;13164;2836;1.1
20044399;282905;1;09.02.2023 00:00;14000;10970;3030;1.1
20044452;282918;1;09.02.2023 00:00;17672;10971;6701;0.9
20044391;260525;1;09.02.2023 00:00;72409;57000;15409;4.0
20044451;282917;1;09.02.2023 00:00;16800;10970;5830;0.7
20044450;282915;1;09.02.2023 00:00;31517;24136;7381;1.6
20044743;258914;1;10.02.2023 00:00;34002;25177;8825;2.1
20044745;274789;1;10.02.2023 00:00;1446107;1290253;155854;81.4
20045342;274789;1;23.02.2023 00:00;1393144;1290253;102891;81.3
20045655;244458;1;01.03.2023 00:00;162970;140416;22554;9.9
20045726;243115;1;02.03.2023 00:00;111845;105315;6530;6.6
20045352;275872;1;02.03.2023 00:00;93338;54850;38488;3.8
20045351;235745;1;03.03.2023 00:00;36546;32910;3636;3.1
20045350;234098;1;03.03.2023 00:00;90042;71308;18734;4.5
20045822;254807;1;03.03.2023 00:00;184277;175520;8757;11.3
20045821;242055;1;04.03.2023 00:00;136820;131640;5180;8.3
20045860;249053;1;04.03.2023 00:00;26000;21940;4060;1.5
20045191;250734;1;04.03.2023 00:00;262588;230370;32218;14.6
20046333;236426;1;05.03.2023 00:00;57767;43883;13884;2.9
20045864;252902;1;05.03.2023 00:00;243334;230374;12960;14.0
20046032;257703;1;06.03.2023 00:00;65293;54432;10861;3.8
20046315;258364;1;07.03.2023 00:00;77146;70214;6932;4.4
20046033;271399;1;07.03.2023 00:00;119562;88706;30856;5.5
20046076;271400;1;07.03.2023 00:00;43677;47378;-3701;2.9
20046820;275207;1;17.03.2023 00:00;192796;146998;45798;10.0
20046821;236601;1;20.03.2023 00:00;55100;43880;11220;2.9
20046819;239882;1;20.03.2023 00:00;44885;32912;11973;2.4
20046818;234742;1;20.03.2023 00:00;207546;175520;32026;10.9
20047569;234097;1;21.03.2023 00:00;320916;301680;19236;18.5
20046948;274143;1;22.03.2023 00:00;73475;76795;-3320;5.0
20046950;240139;1;22.03.2023 00:00;56545;38395;18150;2.7
20047239;236602;1;23.03.2023 00:00;164335;153585;10750;9.7
20047213;283057;1;23.03.2023 00:00;15358;15358;0;3.0
20047227;271914;1;23.03.2023 00:00;330763;282244;48519;17.9
20047067;273565;1;24.03.2023 00:00;43847;36736;7111;2.4
20047006;262246;1;25.03.2023 00:00;348883;300204;48679;19.1
20047130;274930;1;27.03.2023 00:00;176834;141514;35320;9.4
20046949;283373;1;28.03.2023 00:00;80008;60482;19526;3.9
20047129;271400;1;29.03.2023 00:00;86134;61998;24136;4.3
20047128;271399;1;29.03.2023 00:00;68480;56448;12032;4.2
20047787;266175;1;29.03.2023 00:00;297595;270931;26664;17.0
20047127;270733;1;30.03.2023 00:00;47485;30400;17085;2.5
20048092;275207;1;31.03.2023 00:00;233318;201851;31467;13.8
20048091;258364;1;31.03.2023 00:00;78197;70210;7987;4.9
20048780;274135;1;24.04.2023 00:00;50240;4;50236;0.0
20048775;;1;24.04.2023 00:00;0;0;0;0.0
20048986;279756;1;24.04.2023 00:00;446100;368424;77676;25.0
20048987;283903;1;26.04.2023 00:00;79500;55728;23772;3.8
20048989;236392;1;26.04.2023 00:00;119020;102168;16852;6.8
20048985;278355;1;27.04.2023 00:00;178686;157898;20788;10.4
20048988;236237;1;28.04.2023 00:00;141031;102168;38863;6.7
20048993;261524;1;28.04.2023 00:00;134936;102170;32766;7.1
20048991;257462;1;28.04.2023 00:00;25300;21672;3628;1.4
20048990;236631;1;01.05.2023 00:00;43057;30962;12095;1.9
20048992;259676;1;01.05.2023 00:00;142514;123840;18674;8.2
20049089;259676;1;01.05.2023 00:00;224693;198146;26547;13.7
20049088;236915;1;02.05.2023 00:00;110658;99075;11583;6.7
20049087;234789;1;03.05.2023 00:00;79992;65018;14974;4.5
20049279;234028;1;03.05.2023 00:00;234278;204339;29939;13.3
20049280;284000;1;03.05.2023 00:00;47218;43346;3872;2.9
20049421;237427;1;04.05.2023 00:00;80034;74306;5728;5.0
20049281;284002;1;04.05.2023 00:00;27246;24770;2476;1.7
20049305;277257;1;04.05.2023 00:00;360444;306506;53938;20.2
20049422;237611;1;06.05.2023 00:00;89168;74306;14862;4.9
20049954;257462;1;06.05.2023 00:00;25003;21675;3328;1.6
20049427;279949;1;08.05.2023 00:00;114356;102171;12185;6.3
20049468;241513;1;08.05.2023 00:00;109514;102170;7344;6.7
20049490;278355;1;09.05.2023 00:00;338120;306506;31614;19.6
20049469;254048;1;09.05.2023 00:00;69532;65018;4514;4.4
20049492;;1;10.05.2023 00:00;0;0;0;0.0
20049828;274135;1;15.05.2023 00:00;222697;108866;113831;8.5
20049880;274789;1;16.05.2023 00:00;1472608;1290244;182364;80.5
20050132;275207;1;02.06.2023 00:00;494078;403698;90380;25.7
20050768;274972;1;09.06.2023 00:00;182133;157970;24163;10.1
20051063;237311;1;10.06.2023 00:00;160860;136028;24832;10.1
20051062;234582;1;10.06.2023 00:00;30482;26330;4152;1.7
20051585;283917;1;12.06.2023 00:00;657915;565040;92875;35.7
20051627;260076;1;14.06.2023 00:00;62600;44176;18424;2.8
20051584;273959;1;14.06.2023 00:00;39993;18146;21847;1.6
20051466;284069;1;15.06.2023 00:00;38798;27555;11243;1.9
20051432;266990;1;15.06.2023 00:00;224258;193075;31183;12.0
20051465;284065;1;15.06.2023 00:00;33800;27552;6248;1.6
20051430;255264;1;16.06.2023 00:00;25000;20160;4840;1.3
20051246;266437;1;16.06.2023 00:00;1256856;1094400;162456;68.5
20051782;274789;1;22.06.2023 00:00;1488858;1290242;198616;80.9
20052101;274789;1;27.06.2023 00:00;1426558;1290246;136312;78.6
20051817;244458;1;04.07.2023 00:00;339808;280834;58974;17.7
20051815;240139;1;05.07.2023 00:00;93625;76790;16835;4.7
20051816;237113;1;05.07.2023 00:00;191910;153582;38328;9.4
20052539;234098;1;06.07.2023 00:00;72600;76790;-4190;4.8
20052540;239882;1;06.07.2023 00:00;42214;32913;9301;2.0
20052542;250734;1;06.07.2023 00:00;80002;76793;3209;4.8
20052565;281523;1;07.07.2023 00:00;67206;53760;13446;3.3
20052657;284600;1;07.07.2023 00:00;150046;134402;15644;8.3
20053034;243115;1;07.08.2023 00:00;320652;280832;39820;18.7
20053519;258364;1;07.08.2023 00:00;28310;30716;-2406;1.8
20053518;241453;1;07.08.2023 00:00;29587;26328;3259;1.7
20053030;242055;1;08.08.2023 00:00;115265;87760;27505;7.0
20053028;236211;1;08.08.2023 00:00;31189;21940;9249;1.5
20053029;236435;1;09.08.2023 00:00;42031;43880;-1849;2.7
20053027;235745;1;09.08.2023 00:00;51871;21943;29928;2.0
20053031;274143;1;09.08.2023 00:00;157592;153582;4010;9.7
20053032;275872;1;09.08.2023 00:00;56700;43880;12820;3.1
20054113;284966;1;10.08.2023 00:00;340808;297360;43448;20.0
20053520;266175;1;11.08.2023 00:00;284631;250268;34363;15.8
20054277;266175;1;12.08.2023 00:00;279402;257152;22250;15.9
20054344;271285;1;14.08.2023 00:00;58605;54602;4003;3.2
20053026;284600;1;14.08.2023 00:00;67000;53760;13240;3.5
20054343;271283;1;15.08.2023 00:00;122343;107520;14823;6.6
20054346;272319;1;15.08.2023 00:00;90555;80640;9915;4.9
20054341;227750;1;15.08.2023 00:00;57682;53763;3919;3.2
20054340;224778;1;15.08.2023 00:00;62500;53760;8740;3.5
20054342;232273;1;16.08.2023 00:00;61832;53760;8072;3.2
20054345;272318;1;16.08.2023 00:00;61000;53760;7240;3.2
20054347;280917;1;16.08.2023 00:00;31563;26882;4681;1.7
20054348;284921;1;16.08.2023 00:00;33400;26880;6520;1.8
20054109;284663;1;16.08.2023 00:00;273671;241920;31751;14.7
20054111;284276;1;17.08.2023 00:00;80180;68881;11299;6.5
20054110;284413;1;17.08.2023 00:00;44275;30403;13872;1.8
20054563;266990;1;18.08.2023 00:00;187461;157968;29493;10.1
20054995;254807;1;22.08.2023 00:00;160577;131642;28935;7.9
20054994;250734;1;23.08.2023 00:00;187364;153580;33784;9.9
20054993;242407;1;25.08.2023 00:00;46487;38395;8092;2.4
20054992;239882;1;25.08.2023 00:00;54612;32912;21700;2.0
20054991;234097;1;26.08.2023 00:00;350524;296192;54332;19.2
20055059;266437;1;28.08.2023 00:00;648766;546256;102510;35.7
20055764;281494;1;07.09.2023 00:00;7740;7740;0;0.0
20055060;266437;1;07.09.2023 00:00;583813;547205;36608;33.7
20055273;271400;1;09.09.2023 00:00;85087;72074;13013;4.5
20055272;271399;1;09.09.2023 00:00;70724;63002;7722;4.1
20055340;283373;1;10.09.2023 00:00;71456;52418;19038;3.5
20055334;273959;1;10.09.2023 00:00;18549;16130;2419;1.1
20055333;257703;1;10.09.2023 00:00;54750;38306;16444;2.5
20055407;244458;1;10.09.2023 00:00;618017;525471;92546;33.2
20055514;243115;1;13.09.2023 00:00;344556;315940;28616;19.5
20055610;234742;1;14.09.2023 00:00;253349;219403;33946;10.6
20055758;274789;1;15.09.2023 00:00;1445944;1290250;155694;81.6
20055999;285154;1;20.09.2023 00:00;72085;45603;26482;3.0
20056000;285154;1;20.09.2023 00:00;57399;45602;11797;3.0
20056001;285154;1;21.09.2023 00:00;195230;174802;20428;11.6
20055919;266990;1;21.09.2023 00:00;140386;122865;17521;7.9
20055921;276584;1;21.09.2023 00:00;49002;40591;8411;2.6
20055918;257817;1;22.09.2023 00:00;61898;52658;9240;3.9
20055925;285226;1;22.09.2023 00:00;32041;26331;5710;1.8
20056672;277221;1;05.10.2023 00:00;483113;425609;57504;32.5
20056719;283917;1;06.10.2023 00:00;349066;282242;66824;17.5
20056718;271914;1;09.10.2023 00:00;260185;241922;18263;14.9
20056524;274789;1;10.10.2023 00:00;1479166;1290247;188919;82.9
20057375;254807;1;24.10.2023 00:00;206754;175522;31232;12.0
20057386;236601;1;25.10.2023 00:00;52624;43882;8742;2.9
20057374;236602;1;25.10.2023 00:00;178130;153580;24550;9.6
20057373;234098;1;26.10.2023 00:00;94600;76790;17810;4.8
20057194;265724;1;26.10.2023 00:00;152027;117379;34648;7.3
20057764;237263;1;26.10.2023 00:00;33933;32910;1023;2.1
20057195;265724;1;27.10.2023 00:00;150750;136028;14722;8.6
20057196;274930;1;27.10.2023 00:00;100501;85566;14935;5.3
20057789;274789;1;27.10.2023 00:00;1419314;1290252;129062;78.3
20057987;241454;1;10.11.2023 00:00;178665;144804;33861;9.0
20057983;236393;1;10.11.2023 00:00;130127;109703;20424;7.2
20058085;237297;1;20.11.2023 00:00;141661;109702;31959;8.2
20058248;235285;1;20.11.2023 00:00;77265;65820;11445;4.0
20058247;234096;1;20.11.2023 00:00;189155;162358;26797;10.0
20057251;270733;1;21.11.2023 00:00;40902;30402;10500;1.9
20058703;230137;1;21.11.2023 00:00;65800;53760;12040;3.2
20058704;271284;1;21.11.2023 00:00;38734;26882;11852;1.7
20058702;263774;1;22.11.2023 00:00;231514;215042;16472;13.5
20058701;224778;1;22.11.2023 00:00;62150;53760;8390;3.3
20058706;284276;1;22.11.2023 00:00;18370;18370;0;3.3
20058504;266437;1;23.11.2023 00:00;636464;547202;89262;34.5
20058705;284276;1;23.11.2023 00:00;18370;18370;0;1.9
20058605;266437;1;25.11.2023 00:00;635396;547204;88192;34.8
20058707;271400;1;28.11.2023 00:00;148387;131042;17345;8.2
20058861;243115;1;28.11.2023 00:00;170983;140416;30567;8.6
20058860;234742;1;29.11.2023 00:00;214062;175520;38542;11.3
20058759;234097;1;30.11.2023 00:00;197253;175522;21731;11.8
20058926;265724;1;01.12.2023 00:00;39825;31813;8012;2.1
20059042;274930;1;01.12.2023 00:00;174838;162361;12477;10.8
20059766;;1;13.12.2023 00:00;0;0;0;0.0
20059764;257342;1;13.12.2023 00:00;108853;102170;6683;6.9
20059765;278355;1;14.12.2023 00:00;393728;321988;71740;20.7
20059861;;1;09.01.2024 00:00;0;0;0;0.0
20059860;274930;1;09.01.2024 00:00;192154;149198;42956;9.7
20059856;234098;1;10.01.2024 00:00;107314;76792;30522;5.3
20060175;237688;1;11.01.2024 00:00;96941;56441;40500;3.6
20060137;260076;1;11.01.2024 00:00;54116;40378;13738;2.4
20060136;258914;1;11.01.2024 00:00;32864;26602;6262;1.6
20060139;260525;1;11.01.2024 00:00;62588;38000;24588;2.6
20059857;266175;1;12.01.2024 00:00;312401;260024;52377;17.0
20060489;286266;1;15.01.2024 00:00;6822;1902;4920;0.1
20060488;286257;1;15.01.2024 00:00;103074;82084;20990;5.1
20060660;275207;1;31.01.2024 00:00;253271;219403;33868;15.0
20060824;274972;1;01.02.2024 00:00;76306;70211;6095;4.4
20060822;254049;1;01.02.2024 00:00;37502;30718;6784;2.1
20060821;249053;1;01.02.2024 00:00;132134;87761;44373;6.1
20060889;254807;1;02.02.2024 00:00;178317;164552;13765;10.8
20060887;239882;1;03.02.2024 00:00;29852;27427;2425;1.8
20060888;241454;1;05.02.2024 00:00;176698;140418;36280;8.8
20061050;244458;1;05.02.2024 00:00;495707;421253;74454;26.6
20060890;273959;1;07.02.2024 00:00;17127;10083;7044;0.6
20060952;257703;1;07.02.2024 00:00;119334;105338;13996;6.9
20060959;283373;1;07.02.2024 00:00;71137;55946;15191;3.5
20061200;271399;1;08.02.2024 00:00;37751;26210;11541;1.6
20061201;271399;1;08.02.2024 00:00;45776;24192;21584;1.5
20061202;281494;1;08.02.2024 00:00;165302;165302;0;16.4
20061198;284546;1;09.02.2024 00:00;70681;30082;40599;1.9
20061197;281624;1;09.02.2024 00:00;131017;100483;30534;6.3
20061247;284845;1;12.02.2024 00:00;119082;82562;36520;5.5
20061303;258958;1;12.02.2024 00:00;43000;25600;17400;1.7
20061428;;1;12.02.2024 00:00;0;0;0;0.0
20061572;286585;1;12.02.2024 00:00;1865;1865;0;13.5
20061130;285424;1;13.02.2024 00:00;33052;27962;5090;2.1
20061135;281017;1;13.02.2024 00:00;308897;232072;76825;17.2
20061575;286592;1;15.02.2024 00:00;5594;5594;0;10.9
20061430;263916;1;15.02.2024 00:00;40899;33552;7347;2.7
20061625;;1;15.02.2024 00:00;0;0;0;0.0
20061576;286594;1;15.02.2024 00:00;5754;5754;0;3.5
20061431;283541;1;16.02.2024 00:00;12469;12469;0;0.9
20061429;;1;16.02.2024 00:00;0;0;0;0.0
20061568;282274;1;16.02.2024 00:00;243724;189724;54000;12.6
20061432;286480;1;17.02.2024 00:00;139872;113832;26040;7.7
20061599;258300;1;19.02.2024 00:00;42114;26330;15784;2.0
20061739;234097;1;19.02.2024 00:00;219169;186492;32677;12.0
20061569;274789;1;28.02.2024 00:00;1416239;1290242;125997;80.8
20062618;273959;1;05.03.2024 00:00;24585;26210;-1625;1.9
20062619;274092;1;05.03.2024 00:00;341210;303078;38132;19.1
20062712;286856;1;06.03.2024 00:00;8776;8776;0;1.8
20062616;236426;1;06.03.2024 00:00;52447;43882;8565;2.9
20063053;236602;1;07.03.2024 00:00;192656;164552;28104;10.5
20062620;275872;1;07.03.2024 00:00;43103;38398;4705;2.4
20062615;234742;1;07.03.2024 00:00;147239;131642;15597;8.5
20062474;278663;1;08.03.2024 00:00;44712;19746;24966;1.5
20062645;278663;1;08.03.2024 00:00;56603;55949;654;4.2
20062477;286015;1;09.03.2024 00:00;157138;145903;11235;10.8
20062713;274930;1;11.03.2024 00:00;141717;138224;3493;8.9
20063102;286960;1;12.03.2024 00:00;90118;52238;37880;4.2
20062622;286708;1;12.03.2024 00:00;94247;58320;35927;4.8
20062655;286363;1;12.03.2024 00:00;48637;25233;23404;1.6
20062716;286860;1;13.03.2024 00:00;145328;125282;20046;8.1
20062715;284262;1;13.03.2024 00:00;74491;58323;16168;4.1
20062869;286891;1;14.03.2024 00:00;67472;58323;9149;3.8
20062621;282163;1;14.03.2024 00:00;64913;58322;6591;3.9
20062678;286712;1;14.03.2024 00:00;35168;25383;9785;1.7
20062679;286779;1;14.03.2024 00:00;39431;25382;14049;1.6
20062714;286885;1;15.03.2024 00:00;23478;25382;-1904;1.7
20063183;266437;1;22.03.2024 00:00;655425;547205;108220;36.9
20063373;282978;1;22.03.2024 00:00;44800;27552;17248;2.0
20063294;266437;1;26.03.2024 00:00;631073;547206;83867;35.8
20063685;286990;1;02.04.2024 00:00;21543;12648;8895;0.8
20063472;284921;1;02.04.2024 00:00;41819;26882;14937;1.7
20063473;272320;1;02.04.2024 00:00;67124;53762;13362;3.2
20063471;271285;1;03.04.2024 00:00;84942;80640;4302;5.1
20063679;284966;1;03.04.2024 00:00;372163;282242;89921;19.8
20063582;235987;1;03.04.2024 00:00;59600;53760;5840;3.6
20063838;283917;1;05.04.2024 00:00;323232;282240;40992;18.1
20063836;257703;1;08.04.2024 00:00;118813;105339;13474;6.8
20064117;287057;1;08.04.2024 00:00;306822;250024;56798;16.7
20064116;287057;1;09.04.2024 00:00;107214;99902;7312;6.3
20064115;287057;1;10.04.2024 00:00;123125;102062;21063;6.3
20064114;286860;1;10.04.2024 00:00;34897;25384;9513;2.2
20064108;271399;1;10.04.2024 00:00;67635;50402;17233;3.6
20063835;237297;1;12.04.2024 00:00;69456;43883;25573;3.2
20064109;271400;1;12.04.2024 00:00;34714;26210;8504;1.6
20063837;275207;1;12.04.2024 00:00;321556;280836;40720;18.2
20063912;234096;1;16.04.2024 00:00;116511;100926;15585;6.0
20064106;235285;1;16.04.2024 00:00;42725;35109;7616;2.7
20064107;236393;1;16.04.2024 00:00;121101;100928;20173;6.5
20064105;234582;1;17.04.2024 00:00;55485;43882;11603;2.7
20064110;274789;1;17.04.2024 00:00;1402728;1290255;112473;80.9
20064700;;1;23.04.2024 00:00;0;0;0;0.0
20064702;287352;1;23.04.2024 00:00;52721;34122;18599;2.7
20065328;287487;1;06.05.2024 00:00;90037;90037;0;1.0
20064473;274849;1;07.05.2024 00:00;167676;129777;37899;8.7
20064113;274851;1;08.05.2024 00:00;40456;4;40452;0.0
20065282;235745;1;09.05.2024 00:00;25253;21943;3310;1.4
20065402;236435;1;09.05.2024 00:00;44772;43882;890;2.8
20065400;234097;1;10.05.2024 00:00;442027;394924;47103;26.1
20065401;236211;1;10.05.2024 00:00;26000;21940;4060;1.6
20065405;254807;1;11.05.2024 00:00;184034;153582;30452;9.9
20065403;237263;1;12.05.2024 00:00;13769;21942;-8173;1.4
20065404;241454;1;12.05.2024 00:00;174607;144804;29803;9.6
20065519;283917;1;13.05.2024 00:00;307590;282240;25350;17.6
20065902;274789;1;14.05.2024 00:00;1382951;1290242;92709;81.6
20065407;283373;1;18.05.2024 00:00;54878;52416;2462;3.2
20065406;273959;1;18.05.2024 00:00;18489;28227;-9738;1.7
20065604;274814;1;18.05.2024 00:00;82447;60338;22109;4.8
20065499;286015;1;19.05.2024 00:00;245959;218303;27656;16.2
20065606;286015;1;21.05.2024 00:00;83239;80083;3156;6.0
20065536;278663;1;21.05.2024 00:00;573986;548507;25479;39.9
20065712;276584;1;23.05.2024 00:00;125247;88859;36388;5.7
20065711;266990;1;23.05.2024 00:00;225078;210630;14448;13.6
20066807;287789;1;12.06.2024 00:00;20162;20162;0;6.5
20066809;287795;1;13.06.2024 00:00;20168;20092;76;2.0
20066808;287790;1;13.06.2024 00:00;20160;20160;0;1.4
20066810;287815;1;14.06.2024 00:00;67617;67617;0;11.8
20066811;287816;1;18.06.2024 00:00;81582;81582;0;16.0
20066812;287817;1;19.06.2024 00:00;27753;27753;0;16.0
20066817;287863;1;21.06.2024 00:00;80989;80989;0;8.0
20066813;287818;1;27.06.2024 00:00;70900;40900;30000;13.5
20066815;287820;1;02.07.2024 00:00;11658;11658;0;8.0
20068309;287820;1;04.07.2024 00:00;5418;5418;0;8.0
20068384;;1;04.07.2024 00:00;0;0;0;0.0
20067740;286959;1;04.07.2024 00:00;96208;77229;18979;4.4
20068557;288484;1;04.07.2024 00:00;64306;50006;14300;13.5
20067734;274848;1;05.07.2024 00:00;164357;111133;53224;9.2
20068954;288503;1;08.07.2024 00:00;93054;3;93051;0.0
20067735;274850;1;10.07.2024 00:00;145025;90254;54771;6.4
20067898;287800;1;11.07.2024 00:00;23575;23575;0;3.4
20067824;265724;1;11.07.2024 00:00;357043;297291;59752;19.1
20067736;274851;1;11.07.2024 00:00;37483;35153;2330;2.3
20067860;274930;1;14.07.2024 00:00;63902;42785;21117;3.1
20067864;274930;1;14.07.2024 00:00;90765;86664;4101;6.2
20067976;287158;1;15.07.2024 00:00;231274;141513;89761;10.5
20068805;286015;1;29.07.2024 00:00;255358;176617;78741;14.0
20068804;274930;1;30.07.2024 00:00;48002;42785;5217;2.9
20068710;274789;1;31.07.2024 00:00;1514727;1290242;224485;81.0
20068831;288228;1;31.07.2024 00:00;21300;9873;11427;0.6
20069102;235745;1;05.08.2024 00:00;35180;21942;13238;1.3
20069104;254807;1;05.08.2024 00:00;152779;131640;21139;8.4
20069105;236601;1;06.08.2024 00:00;52477;43882;8595;2.6
20069103;239882;1;06.08.2024 00:00;40100;32910;7190;2.2
20069106;234097;1;06.08.2024 00:00;156556;131642;24914;7.9
20069108;276584;1;07.08.2024 00:00;147266;115187;32079;7.2
20069107;266990;1;07.08.2024 00:00;250025;210631;39394;13.6
20069661;287901;1;15.08.2024 00:00;41300;31586;9714;6.4
20069660;287895;1;15.08.2024 00:00;34303;29236;5067;4.3
20069921;269346;1;26.08.2024 00:00;34252;25602;8650;3.0
20069920;237297;1;26.08.2024 00:00;72051;43882;28169;2.8
20069919;235285;1;27.08.2024 00:00;75424;61436;13988;4.3
20069918;234096;1;27.08.2024 00:00;108411;96538;11873;6.4
20069922;275207;1;27.08.2024 00:00;230583;201850;28733;13.0
20070062;258364;1;28.08.2024 00:00;173458;139321;34137;9.4
20070061;257817;1;28.08.2024 00:00;26200;21940;4260;1.4
20070059;224817;1;29.08.2024 00:00;16458;13166;3292;0.9
20070058;224817;1;29.08.2024 00:00;29791;26330;3461;1.7
20070060;243115;1;29.08.2024 00:00;62631;48269;14362;3.2
20070121;236211;1;29.08.2024 00:00;32922;27427;5495;3.7
20070122;236602;1;29.08.2024 00:00;174647;153582;21065;9.4
20070217;274789;1;30.08.2024 00:00;1407592;1290250;117342;77.4
20070127;286650;1;30.08.2024 00:00;33500;25600;7900;1.7
20070328;274930;1;05.09.2024 00:00;115372;94344;21028;5.6
20070329;287158;1;05.09.2024 00:00;322974;286322;36652;21.5
20070632;;1;06.09.2024 00:00;0;0;0;0.0
20070719;288846;1;09.09.2024 00:00;32217;32217;0;7.6
20070634;275875;1;09.09.2024 00:00;130712;112777;17935;7.6
20070892;287158;1;23.09.2024 00:00;245593;185395;60198;14.3
20070893;274789;1;24.09.2024 00:00;1491785;1290254;201531;81.7
20071465;274092;1;02.10.2024 00:00;338856;303075;35781;18.2
20071466;281829;1;03.10.2024 00:00;88284;71282;17002;4.5
20071512;280717;1;04.10.2024 00:00;56417;20520;35897;1.6
20071513;283330;1;04.10.2024 00:00;55000;53460;1540;3.7
20071662;288076;1;04.10.2024 00:00;36023;27003;9020;1.7
20071665;288156;1;05.10.2024 00:00;50905;25383;25522;1.5
20071664;288126;1;07.10.2024 00:00;201072;174966;26106;11.0
20071658;286257;1;07.10.2024 00:00;50111;43742;6369;2.7
20071660;286860;1;07.10.2024 00:00;85843;72903;12940;4.9
20071661;287921;1;08.10.2024 00:00;61275;58324;2951;3.6
20071663;288088;1;08.10.2024 00:00;68648;58322;10326;3.5
20071659;286712;1;08.10.2024 00:00;17000;14580;2420;1.0
20071041;288702;1;08.10.2024 00:00;114183;101186;12997;6.4
20071043;288705;1;09.10.2024 00:00;113983;101186;12797;6.6
20071044;288706;1;09.10.2024 00:00;109647;101186;8461;6.3
20071042;288704;1;09.10.2024 00:00;94435;75890;18545;4.8
20071681;262246;1;10.10.2024 00:00;326489;300203;26286;18.8
20071040;288670;1;10.10.2024 00:00;31470;25299;6171;1.5
20071682;274789;1;11.10.2024 00:00;1504602;1289872;214730;83.7
20072176;288229;1;16.10.2024 00:00;67298;15501;51797;1.4
20072240;266437;1;16.10.2024 00:00;662437;583779;78658;36.4
20072239;266437;1;19.10.2024 00:00;600538;546735;53803;32.7
20072267;271399;1;21.10.2024 00:00;74395;60480;13915;4.3
20072268;288626;1;21.10.2024 00:00;66702;56451;10251;3.6
20072269;288626;1;22.10.2024 00:00;59022;55442;3580;3.4
20072266;257703;1;22.10.2024 00:00;47599;40322;7277;2.7
20072373;283917;1;22.10.2024 00:00;270569;241923;28646;17.2
20072368;284845;1;23.10.2024 00:00;46399;28161;18238;2.0
20072366;249053;1;23.10.2024 00:00;46413;23041;23372;1.9
20072365;237263;1;24.10.2024 00:00;38983;21942;17041;1.6
20072364;234742;1;24.10.2024 00:00;160859;131642;29217;9.5
20072363;234097;1;24.10.2024 00:00;371151;329104;42047;22.6
20072367;254807;1;26.10.2024 00:00;219484;202949;16535;13.0
20072374;234098;1;26.10.2024 00:00;79480;76790;2690;4.8
20072580;277188;1;27.10.2024 00:00;50608;28163;22445;2.0
20072386;235745;1;27.10.2024 00:00;29500;21940;7560;1.5
20072578;258958;1;27.10.2024 00:00;61247;43525;17722;2.9
20072579;269346;1;27.10.2024 00:00;45739;40323;5416;2.5
20072577;237791;1;28.10.2024 00:00;30373;25602;4771;1.8
20072581;288981;1;28.10.2024 00:00;82344;60802;21542;3.9
20072980;288981;1;28.10.2024 00:00;35890;25602;10288;1.8
20072979;258958;1;28.10.2024 00:00;22025;20482;1543;1.5
20072446;289151;1;31.10.2024 00:00;0;0;0;0.0
20072639;289107;1;31.10.2024 00:00;44100;26208;17892;2.5
20073194;289259;1;06.11.2024 00:00;27962;27962;0;4.0
20073195;289260;1;07.11.2024 00:00;9072;9072;0;2.0
20073196;289261;1;07.11.2024 00:00;12435;12435;0;4.6
20073006;288229;1;12.11.2024 00:00;41502;25258;16244;2.7
20072975;289113;1;14.11.2024 00:00;79441;49091;30350;3.2
20073263;289289;1;14.11.2024 00:00;392814;348878;43936;25.8
20073101;274930;1;16.11.2024 00:00;52412;42783;9629;2.8
20073100;274930;1;16.11.2024 00:00;42502;39494;3008;2.5
20073102;274930;1;16.11.2024 00:00;221353;204048;17305;13.3
20073218;273959;1;17.11.2024 00:00;47201;28224;18977;1.9
20073220;288661;1;17.11.2024 00:00;57722;22179;35543;2.1
20073219;281977;1;17.11.2024 00:00;29043;8964;20079;0.5
20042640;282274;2;03.01.2023 00:00;156595;140711;15884;9.3
20042636;282291;2;03.01.2023 00:00;54088;35106;18982;2.8
20042625;276553;2;04.01.2023 00:00;36002;35106;896;2.4
20042628;277586;2;04.01.2023 00:00;43469;35106;8363;2.1
20042635;282288;2;04.01.2023 00:00;38905;35106;3799;2.4
20042630;277589;2;04.01.2023 00:00;57966;52656;5310;3.3
20042633;277622;2;04.01.2023 00:00;58002;52658;5344;3.1
20042629;277587;2;04.01.2023 00:00;73882;70210;3672;4.3
20042626;276827;2;05.01.2023 00:00;81493;70210;11283;4.4
20042627;276897;2;05.01.2023 00:00;75000;70208;4792;4.2
20042631;277612;2;05.01.2023 00:00;109811;105314;4497;6.4
20042632;277621;2;05.01.2023 00:00;21966;17554;4412;1.4
20042639;282233;2;06.01.2023 00:00;35188;28126;7062;1.8
20042637;282227;2;06.01.2023 00:00;57310;55106;2204;3.6
20042698;281624;2;06.01.2023 00:00;84300;76800;7500;4.6
20042638;282232;2;06.01.2023 00:00;30440;27552;2888;1.8
20042697;268295;2;06.01.2023 00:00;327242;302085;25157;19.6
20042810;279941;2;07.01.2023 00:00;24022;16203;7819;1.0
20042811;280717;2;08.01.2023 00:00;86457;71282;15175;4.5
20042809;273202;2;08.01.2023 00:00;29108;26462;2646;1.6
20042812;281829;2;08.01.2023 00:00;205340;198182;7158;12.9
20042917;234580;2;09.01.2023 00:00;76265;43347;32918;2.8
20042700;;2;09.01.2023 00:00;0;0;0;0.0
20042701;238904;2;09.01.2023 00:00;39002;34058;4944;2.1
20042703;277259;2;09.01.2023 00:00;250310;204338;45972;13.4
20042704;279949;2;10.01.2023 00:00;109994;102170;7824;6.6
20043073;234706;2;10.01.2023 00:00;341518;306504;35014;19.9
20042702;257342;2;12.01.2023 00:00;115315;102170;13145;6.5
20042920;279755;2;12.01.2023 00:00;221767;204336;17431;13.5
20042739;280357;2;13.01.2023 00:00;367202;321986;45216;20.8
20043078;266335;2;14.01.2023 00:00;146318;133130;13188;8.2
20043074;245906;2;14.01.2023 00:00;34436;27866;6570;1.8
20043075;261524;2;14.01.2023 00:00;110052;102170;7882;6.4
20043079;265093;2;15.01.2023 00:00;40003;34059;5944;2.2
20043274;265093;2;15.01.2023 00:00;71048;65016;6032;4.2
20043072;234705;2;15.01.2023 00:00;74627;61922;12705;3.9
20043272;266275;2;15.01.2023 00:00;142972;123842;19130;8.0
20043080;277350;2;16.01.2023 00:00;59795;43344;16451;2.8
20043273;281009;2;16.01.2023 00:00;40801;32258;8543;2.2
20043091;282346;2;16.01.2023 00:00;136318;120968;15350;8.3
20043094;281111;2;16.01.2023 00:00;51795;40226;11569;2.6
20043069;;2;17.01.2023 00:00;0;0;0;0.0
20043193;273725;2;17.01.2023 00:00;85561;71060;14501;4.7
20043561;272412;2;17.01.2023 00:00;89559;71063;18496;4.5
20043545;282727;2;18.01.2023 00:00;2502;2502;0;6.5
20043081;275320;2;18.01.2023 00:00;219004;177652;41352;11.7
20043562;273720;2;19.01.2023 00:00;190343;177653;12690;11.5
20043526;282832;2;19.01.2023 00:00;84273;71061;13212;4.6
20043565;279851;2;20.01.2023 00:00;83002;71063;11939;4.8
20043563;273724;2;20.01.2023 00:00;165817;142123;23694;9.4
20043564;275799;2;21.01.2023 00:00;148142;142122;6020;9.3
20043994;273723;2;29.01.2023 00:00;388228;355302;32926;23.2
20043898;259676;2;30.01.2023 00:00;248613;222914;25699;13.8
20043412;;2;30.01.2023 00:00;0;0;0;0.0
20044024;239082;2;31.01.2023 00:00;105573;99075;6498;6.6
20043811;281763;2;31.01.2023 00:00;276832;241347;35485;15.3
20043900;268275;2;01.02.2023 00:00;40742;40226;516;2.6
20043901;282871;2;02.02.2023 00:00;38002;32258;5744;2.2
20043899;267344;2;02.02.2023 00:00;36205;32256;3949;1.9
20043767;;2;02.02.2023 00:00;0;0;0;0.0
20044053;271190;2;02.02.2023 00:00;116538;102062;14476;6.7
20044055;272577;2;02.02.2023 00:00;87197;75602;11595;5.0
20044054;271989;2;03.02.2023 00:00;43532;25380;18152;1.7
20044052;246816;2;03.02.2023 00:00;221170;211680;9490;13.5
20044056;281147;2;04.02.2023 00:00;30570;27002;3568;1.8
20044123;258958;2;04.02.2023 00:00;47761;31361;16400;1.9
20044070;268295;2;04.02.2023 00:00;288570;259842;28728;17.2
20044071;282984;2;04.02.2023 00:00;31876;26240;5636;1.6
20044263;270683;2;05.02.2023 00:00;303642;262404;41238;16.7
20044266;270683;2;06.02.2023 00:00;36002;31362;4640;2.0
20044267;281624;2;06.02.2023 00:00;69000;65281;3719;4.0
20044405;237113;2;06.02.2023 00:00;170831;153582;17249;9.6
20044454;252902;2;07.02.2023 00:00;24003;21943;2060;1.5
20044406;234097;2;07.02.2023 00:00;296921;264379;32542;17.0
20044453;242407;2;08.02.2023 00:00;27329;38397;-11068;2.6
20044456;274268;2;08.02.2023 00:00;347415;284240;63175;19.0
20044425;;2;08.02.2023 00:00;0;0;0;0.0
20044455;273723;2;10.02.2023 00:00;265336;248714;16622;16.3
20044878;273133;2;11.02.2023 00:00;130491;106593;23898;7.8
20044877;273132;2;11.02.2023 00:00;301193;284240;16953;18.5
20044435;;2;12.02.2023 00:00;0;0;0;0.0
20044619;271281;2;12.02.2023 00:00;255581;207062;48519;13.6
20044620;272699;2;13.02.2023 00:00;233768;207062;26706;13.0
20045134;253693;2;14.02.2023 00:00;42272;32258;10014;2.1
20044633;280666;2;14.02.2023 00:00;37862;32259;5603;2.2
20044631;254048;2;14.02.2023 00:00;85896;58826;27070;4.0
20044629;233776;2;15.02.2023 00:00;149629;123843;25786;8.0
20044630;252247;2;15.02.2023 00:00;134621;130034;4587;8.3
20044749;242275;2;16.02.2023 00:00;57493;49536;7957;3.0
20044750;278863;2;16.02.2023 00:00;215180;204338;10842;13.3
20044747;234578;2;16.02.2023 00:00;47000;43344;3656;2.8
20044748;238802;2;16.02.2023 00:00;28500;24768;3732;1.6
20044911;235286;2;17.02.2023 00:00;207762;173378;34384;11.2
20044914;277259;2;17.02.2023 00:00;348286;306506;41780;19.7
20044915;279757;2;18.02.2023 00:00;130699;123842;6857;8.0
20044912;244550;2;19.02.2023 00:00;69743;61920;7823;4.0
20044913;251807;2;19.02.2023 00:00;185980;173378;12602;11.3
20045031;278355;2;20.02.2023 00:00;324534;306506;18028;19.8
20045030;245905;2;20.02.2023 00:00;32075;21674;10401;1.4
20045650;277261;2;21.02.2023 00:00;363793;346754;17039;22.2
20045033;;2;22.02.2023 00:00;0;0;0;0.0
20045195;283199;2;22.02.2023 00:00;65379;30422;34957;2.1
20045194;283199;2;22.02.2023 00:00;9500;20090;-10590;1.5
20045193;283195;2;22.02.2023 00:00;93466;82658;10808;6.1
20045192;283195;2;23.02.2023 00:00;23291;20666;2625;1.4
20045411;283355;2;23.02.2023 00:00;1724;1724;0;2.8
20045353;276216;2;23.02.2023 00:00;38464;25233;13231;1.6
20045406;283271;2;23.02.2023 00:00;36603;26883;9720;1.7
20045409;283259;2;23.02.2023 00:00;78395;55109;23286;3.7
20045410;283308;2;24.02.2023 00:00;67601;55104;12497;3.4
20045408;282131;2;24.02.2023 00:00;245329;220418;24911;14.1
20045414;283220;2;25.02.2023 00:00;1150;1150;0;2.4
20046096;281511;2;25.02.2023 00:00;148147;125822;22325;8.0
20045978;283546;2;25.02.2023 00:00;58954;58322;632;4.0
20045724;271190;2;26.02.2023 00:00;22854;18362;4492;1.2
20045412;283120;2;26.02.2023 00:00;12049;15363;-3314;1.1
20045203;;2;26.02.2023 00:00;0;0;0;0.0
20045413;283120;2;26.02.2023 00:00;5122;5122;0;0.3
20045625;283445;2;26.02.2023 00:00;1294;1294;0;5.8
20045656;273870;2;26.02.2023 00:00;77399;71060;6339;4.6
20045659;283391;2;26.02.2023 00:00;73002;71062;1940;4.8
20045658;283389;2;27.02.2023 00:00;86968;74292;12676;4.6
20045657;279851;2;27.02.2023 00:00;148287;166671;-18384;9.4
20046029;280893;2;28.02.2023 00:00;89286;71063;18223;4.7
20046030;283391;2;28.02.2023 00:00;74609;71063;3546;4.6
20046088;283576;2;28.02.2023 00:00;151423;142123;9300;9.1
20045824;279589;2;01.03.2023 00:00;147996;102170;45826;6.8
20045723;;2;01.03.2023 00:00;0;0;0;0.0
20045823;234093;2;02.03.2023 00:00;47336;43346;3990;2.8
20045825;234704;2;03.03.2023 00:00;101277;83597;17680;5.5
20045999;282713;2;08.03.2023 00:00;133303;105267;28036;6.6
20046152;280190;2;08.03.2023 00:00;76906;71210;5696;4.5
20046150;257340;2;08.03.2023 00:00;135444;123840;11604;7.8
20046157;283225;2;09.03.2023 00:00;28481;24771;3710;1.5
20046158;281317;2;09.03.2023 00:00;28002;24770;3232;1.5
20046151;274440;2;09.03.2023 00:00;28002;24770;3232;1.5
20046159;278577;2;09.03.2023 00:00;282279;266258;16021;16.4
20046248;277259;2;10.03.2023 00:00;322102;306506;15596;19.7
20046249;278280;2;11.03.2023 00:00;112517;102170;10347;6.2
20046250;279434;2;11.03.2023 00:00;119424;102944;16480;6.5
20046246;239082;2;12.03.2023 00:00;114374;102168;12206;6.0
20046339;236237;2;12.03.2023 00:00;115523;102175;13348;6.3
20046338;234028;2;12.03.2023 00:00;223664;204339;19325;13.3
20046383;252143;2;13.03.2023 00:00;223288;204339;18949;12.7
20046384;259089;2;14.03.2023 00:00;32822;21675;11147;1.4
20046382;237576;2;14.03.2023 00:00;76002;71210;4792;4.1
20046507;234706;2;15.03.2023 00:00;216247;204342;11905;12.4
20046506;;2;15.03.2023 00:00;0;0;0;0.0
20046867;269494;2;15.03.2023 00:00;223227;177652;45575;12.1
20046869;273725;2;16.03.2023 00:00;82285;71062;11223;5.5
20046868;273133;2;17.03.2023 00:00;87235;71060;16175;4.6
20046870;283694;2;17.03.2023 00:00;79846;71062;8784;4.7
20047548;279851;2;20.03.2023 00:00;167761;142123;25638;9.8
20046816;;2;20.03.2023 00:00;0;0;0;0.0
20047071;283621;2;21.03.2023 00:00;40002;12118;27884;0.8
20047070;283620;2;21.03.2023 00:00;20487;15845;4642;1.4
20047131;281725;2;21.03.2023 00:00;2975;2975;0;0.0
20046509;275246;2;21.03.2023 00:00;104641;77353;27288;5.0
20046511;282942;2;22.03.2023 00:00;35002;28562;6440;2.2
20047134;278030;2;22.03.2023 00:00;66868;52360;14508;3.9
20046512;282944;2;22.03.2023 00:00;30002;28562;1440;2.0
20046508;269893;2;22.03.2023 00:00;305710;241345;64365;16.5
20046510;281763;2;23.03.2023 00:00;254554;241346;13208;15.5
20046664;268274;2;24.03.2023 00:00;88398;80450;7948;4.9
20046665;279169;2;24.03.2023 00:00;348926;322213;26713;20.2
20046729;268975;2;25.03.2023 00:00;337305;321794;15511;19.9
20047008;238762;2;27.03.2023 00:00;20427;13829;6598;0.9
20047069;276788;2;27.03.2023 00:00;72991;64516;8475;4.0
20047068;274474;2;27.03.2023 00:00;39243;32256;6987;2.3
20047133;250493;2;27.03.2023 00:00;452930;408674;44256;27.5
20047132;239280;2;29.03.2023 00:00;223040;204339;18701;12.7
20047186;280357;2;29.03.2023 00:00;226756;222914;3842;13.9
20047184;244962;2;30.03.2023 00:00;28002;24770;3232;1.5
20047185;278863;2;30.03.2023 00:00;328642;306506;22136;19.1
20047228;241154;2;31.03.2023 00:00;47002;43346;3656;2.6
20047233;277256;2;31.03.2023 00:00;37811;30962;6849;2.0
20047476;283406;2;01.04.2023 00:00;75993;58322;17671;3.8
20047182;;2;01.04.2023 00:00;0;0;0;0.0
20047782;250490;2;01.04.2023 00:00;28961;20483;8478;1.8
20047475;271672;2;01.04.2023 00:00;35620;27542;8078;1.8
20047781;250489;2;01.04.2023 00:00;89485;76162;13323;5.0
20047780;250488;2;02.04.2023 00:00;71090;44802;26288;2.9
20047779;250487;2;02.04.2023 00:00;52057;51202;855;3.3
20047778;250486;2;02.04.2023 00:00;178259;185602;-7343;12.0
20047784;281624;2;03.04.2023 00:00;144902;112002;32900;7.2
20047783;268295;2;03.04.2023 00:00;25977;42882;-16905;2.6
20047894;283391;2;04.04.2023 00:00;104661;71063;33598;4.9
20047183;;2;04.04.2023 00:00;0;0;0;0.0
20048259;279851;2;04.04.2023 00:00;78756;72354;6402;4.7
20047893;273870;2;04.04.2023 00:00;74333;71060;3273;4.6
20047870;;2;05.04.2023 00:00;0;0;0;0.0
20048096;224496;2;05.04.2023 00:00;66668;37280;29388;2.5
20047898;268453;2;05.04.2023 00:00;44028;40226;3802;2.6
20048518;268274;2;06.04.2023 00:00;88374;80452;7922;5.2
20047896;259962;2;06.04.2023 00:00;52302;32258;20044;2.1
20047899;274448;2;06.04.2023 00:00;33536;32258;1278;2.1
20048138;264012;2;06.04.2023 00:00;37311;24768;12543;1.6
20048135;257102;2;11.04.2023 00:00;31503;24770;6733;1.6
20048137;279590;2;11.04.2023 00:00;197208;173380;23828;11.0
20048394;274789;2;12.04.2023 00:00;1381087;1290240;90847;83.1
20048197;237781;2;12.04.2023 00:00;28347;24770;3577;1.6
20048196;;2;12.04.2023 00:00;0;0;0;0.0
20048537;244458;2;20.04.2023 00:00;237767;210626;27141;13.8
20048467;235745;2;21.04.2023 00:00;23477;21942;1535;1.6
20048465;240139;2;21.04.2023 00:00;175903;153582;22321;9.4
20048781;283406;2;22.04.2023 00:00;75110;58320;16790;3.8
20048779;272577;2;24.04.2023 00:00;60220;51302;8918;3.5
20049352;249831;2;24.04.2023 00:00;193116;120747;72369;12.3
20048681;;2;24.04.2023 00:00;0;0;0;0.0
20048983;283868;2;25.04.2023 00:00;50723;32259;18464;2.2
20048984;283915;2;26.04.2023 00:00;99858;80450;19408;5.3
20048683;;2;26.04.2023 00:00;0;0;0;0.0
20048842;283391;2;26.04.2023 00:00;95435;71062;24373;4.7
20049348;279851;2;27.04.2023 00:00;116660;106592;10068;6.7
20048841;269494;2;27.04.2023 00:00;124695;106592;18103;6.6
20049346;273720;2;27.04.2023 00:00;181978;177652;4326;10.9
20049349;283694;2;28.04.2023 00:00;75002;71062;3940;4.3
20048982;273725;2;28.04.2023 00:00;86723;71062;15661;4.3
20049423;275058;2;28.04.2023 00:00;80481;71062;9419;4.5
20049536;275320;2;29.04.2023 00:00;108575;106594;1981;7.9
20049648;273720;2;11.05.2023 00:00;86691;71063;15628;4.8
20049830;283391;2;12.05.2023 00:00;167559;142122;25437;9.3
20050129;283389;2;12.05.2023 00:00;185283;177650;7633;11.4
20049500;;2;17.05.2023 00:00;0;0;0;0.0
20049649;279169;2;22.05.2023 00:00;348866;321794;27072;21.4
20049721;273854;2;23.05.2023 00:00;50626;40226;10400;2.7
20049719;268975;2;23.05.2023 00:00;371178;321794;49384;20.6
20049769;260373;2;24.05.2023 00:00;75162;78772;-3610;5.2
20049907;;2;24.05.2023 00:00;0;0;0;0.0
20049538;280966;2;25.05.2023 00:00;110522;71062;39460;4.6
20050266;273870;2;25.05.2023 00:00;84738;71060;13678;4.8
20050263;;2;25.05.2023 00:00;0;0;0;0.0
20050122;239321;2;26.05.2023 00:00;34899;31362;3537;1.9
20050125;245703;2;26.05.2023 00:00;22748;20480;2268;1.7
20050123;239322;2;26.05.2023 00:00;42202;30722;11480;2.0
20050124;245702;2;26.05.2023 00:00;18465;22400;-3935;1.8
20050126;283873;2;27.05.2023 00:00;145006;102400;42606;7.3
20050165;283735;2;30.05.2023 00:00;33561;28162;5399;1.8
20050162;274930;2;30.05.2023 00:00;166970;161261;5709;12.1
20050207;282234;2;31.05.2023 00:00;49030;27554;21476;1.7
20050206;282230;2;31.05.2023 00:00;31002;27554;3448;1.9
20050205;282229;2;31.05.2023 00:00;52845;27552;25293;2.0
20050208;282235;2;31.05.2023 00:00;29207;27554;1653;1.9
20050726;267914;2;01.06.2023 00:00;37912;25921;11991;1.7
20050204;282228;2;01.06.2023 00:00;42585;41328;1257;3.5
20050909;284262;2;01.06.2023 00:00;69519;63722;5797;4.4
20050727;272577;2;01.06.2023 00:00;60809;51302;9507;3.5
20050730;271356;2;02.06.2023 00:00;23563;16455;7108;1.2
20050731;271357;2;02.06.2023 00:00;28178;17552;10626;1.8
20050732;271358;2;02.06.2023 00:00;23389;12067;11322;1.3
20050725;259741;2;02.06.2023 00:00;12942;12067;875;0.8
20051290;283975;2;02.06.2023 00:00;69976;53462;16514;3.5
20051291;284212;2;02.06.2023 00:00;29002;27002;2000;1.7
20051292;284213;2;02.06.2023 00:00;32543;27002;5541;1.7
20050211;284125;2;02.06.2023 00:00;1148;1148;0;1.0
20050153;;2;03.06.2023 00:00;0;0;0;0.0
20051038;283576;2;03.06.2023 00:00;159578;106592;52986;7.5
20051037;;2;05.06.2023 00:00;0;0;0;0.0
20051039;283694;2;05.06.2023 00:00;73981;71060;2921;5.2
20050771;279755;2;06.06.2023 00:00;300797;204338;96459;12.9
20050766;251807;2;07.06.2023 00:00;197737;173378;24359;11.5
20050888;277258;2;08.06.2023 00:00;61796;43346;18450;2.6
20050875;254918;2;08.06.2023 00:00;34221;20898;13323;1.3
20050889;277260;2;08.06.2023 00:00;53996;49538;4458;3.2
20050871;235286;2;09.06.2023 00:00;78530;77402;1128;4.6
20050873;236666;2;09.06.2023 00:00;70652;65016;5636;3.9
20051244;241154;2;09.06.2023 00:00;80034;61922;18112;4.1
20050872;235286;2;09.06.2023 00:00;24002;21674;2328;1.3
20050950;279589;2;09.06.2023 00:00;101055;102170;-1115;6.9
20050949;266335;2;12.06.2023 00:00;123368;102171;21197;6.4
20051245;282713;2;12.06.2023 00:00;109035;99074;9961;6.2
20051160;234706;2;13.06.2023 00:00;468268;408674;59594;25.2
20050892;279434;2;14.06.2023 00:00;122461;102170;20291;6.4
20051048;279756;2;14.06.2023 00:00;466074;408674;57400;25.7
20051242;278577;2;16.06.2023 00:00;168972;148608;20364;9.5
20051143;280357;2;16.06.2023 00:00;398248;346754;51494;22.1
20051428;234094;2;18.06.2023 00:00;37577;37152;425;2.6
20051429;252247;2;18.06.2023 00:00;138531;123842;14689;7.8
20051437;284339;2;18.06.2023 00:00;23600;21672;1928;1.5
20050874;238904;2;18.06.2023 00:00;68495;43347;25148;2.8
20051453;278030;2;19.06.2023 00:00;66262;52361;13901;3.5
20050966;284243;2;19.06.2023 00:00;17089;24768;-7679;1.6
20051454;278030;2;19.06.2023 00:00;149934;133280;16654;8.4
20051588;284143;2;20.06.2023 00:00;39889;28560;11329;1.8
20051587;284143;2;20.06.2023 00:00;32379;28560;3819;1.8
20051586;284126;2;20.06.2023 00:00;7004;5955;1049;0.4
20051589;284145;2;20.06.2023 00:00;26125;28560;-2435;1.8
20051711;281763;2;20.06.2023 00:00;357476;321796;35680;19.9
20051709;268453;2;21.06.2023 00:00;50588;40227;10361;2.9
20051708;268274;2;21.06.2023 00:00;88352;80450;7902;5.1
20051710;276704;2;22.06.2023 00:00;43982;32258;11724;2.1
20051777;283389;2;22.06.2023 00:00;137921;106592;31329;6.7
20051701;;2;22.06.2023 00:00;0;0;0;0.0
20051778;283391;2;23.06.2023 00:00;128100;106592;21508;6.6
20051992;283391;2;23.06.2023 00:00;113113;106592;6521;6.9
20052344;275799;2;23.06.2023 00:00;122303;106592;15711;6.5
20051990;273720;2;24.06.2023 00:00;222345;213185;9160;13.3
20051776;279851;2;24.06.2023 00:00;111260;106592;4668;6.6
20051989;272412;2;25.06.2023 00:00;126298;106592;19706;7.0
20052084;283576;2;25.06.2023 00:00;111038;106592;4446;6.5
20051991;273725;2;26.06.2023 00:00;121023;106590;14433;6.8
20052351;284604;2;26.06.2023 00:00;245772;226748;19024;14.2
20052327;280966;2;27.06.2023 00:00;118650;106592;12058;6.8
20051702;;2;27.06.2023 00:00;0;0;0;0.0
20051870;283405;2;28.06.2023 00:00;82651;58322;24329;4.1
20052517;284641;2;28.06.2023 00:00;8780;8780;0;5.5
20051819;275207;2;28.06.2023 00:00;575655;526562;49093;33.6
20051818;284372;2;30.06.2023 00:00;54043;30401;23642;2.0
20052168;;2;30.06.2023 00:00;0;0;0;0.0
20052230;281524;2;01.07.2023 00:00;219161;199922;19239;12.2
20052169;273854;2;01.07.2023 00:00;65574;40225;25349;2.6
20052328;271601;2;01.07.2023 00:00;43252;32259;10993;2.1
20052170;279757;2;02.07.2023 00:00;148465;123842;24623;7.8
20052232;259676;2;02.07.2023 00:00;151853;123845;28008;8.0
20052234;279756;2;03.07.2023 00:00;331004;308054;22950;19.2
20052331;277261;2;04.07.2023 00:00;239311;222914;16397;13.8
20052332;279590;2;04.07.2023 00:00;143912;123840;20072;7.9
20052515;234704;2;05.07.2023 00:00;45202;43346;1856;2.8
20052516;261524;2;05.07.2023 00:00;110060;102170;7890;6.4
20052514;233776;2;05.07.2023 00:00;195432;173376;22056;10.5
20052551;278280;2;06.07.2023 00:00;103805;102172;1633;6.7
20052770;283915;2;06.07.2023 00:00;47000;40224;6776;2.4
20052769;268032;2;06.07.2023 00:00;86935;80448;6487;5.1
20053036;273870;2;24.07.2023 00:00;182278;142126;40152;9.5
20053077;284604;2;25.07.2023 00:00;120772;106592;14180;7.2
20053080;283694;2;25.07.2023 00:00;112459;106590;5869;7.4
20053061;273133;2;25.07.2023 00:00;124286;107047;17239;7.5
20053537;273725;2;26.07.2023 00:00;126626;106590;20036;7.2
20053899;279851;2;26.07.2023 00:00;109718;106592;3126;7.3
20053259;;2;27.07.2023 00:00;0;0;0;0.0
20053270;278030;2;27.07.2023 00:00;228001;152320;75681;9.6
20053293;281317;2;28.07.2023 00:00;64344;34058;30286;2.2
20053296;283903;2;28.07.2023 00:00;32663;24770;7893;1.6
20053294;283225;2;28.07.2023 00:00;37463;34058;3405;2.3
20053292;243758;2;29.07.2023 00:00;56947;43347;13600;2.7
20053522;256199;2;29.07.2023 00:00;54178;49538;4640;3.1
20053333;236885;2;29.07.2023 00:00;25500;24768;732;1.5
20053334;237576;2;29.07.2023 00:00;68286;65018;3268;4.1
20053337;254050;2;29.07.2023 00:00;61483;52634;8849;3.5
20053335;239082;2;30.07.2023 00:00;107010;102170;4840;6.6
20053339;266335;2;30.07.2023 00:00;141114;130034;11080;8.2
20053340;280190;2;30.07.2023 00:00;76839;71210;5629;4.5
20053338;257340;2;31.07.2023 00:00;144389;123842;20547;7.8
20053336;251807;2;31.07.2023 00:00;135160;123840;11320;7.6
20053341;280357;2;31.07.2023 00:00;213582;198146;15436;12.3
20053416;279755;2;01.08.2023 00:00;216875;204338;12537;12.9
20053525;277257;2;02.08.2023 00:00;210974;204336;6638;12.4
20053523;279590;2;02.08.2023 00:00;312202;281736;30466;17.8
20053596;244727;2;03.08.2023 00:00;163971;154802;9169;9.3
20053598;250535;2;04.08.2023 00:00;69993;58826;11167;3.8
20053599;277256;2;04.08.2023 00:00;42163;40250;1913;2.5
20053594;234830;2;04.08.2023 00:00;108892;102170;6722;6.1
20053601;279589;2;04.08.2023 00:00;115486;102170;13316;6.4
20053593;234706;2;05.08.2023 00:00;223548;204338;19210;12.5
20053600;277259;2;05.08.2023 00:00;207698;204340;3358;12.7
20053595;236237;2;06.08.2023 00:00;114998;102170;12828;6.3
20053602;273109;2;06.08.2023 00:00;28002;24770;3232;1.7
20053597;250188;2;06.08.2023 00:00;68672;65019;3653;4.1
20053592;234578;2;07.08.2023 00:00;148021;145516;2505;9.2
20053524;;2;07.08.2023 00:00;0;0;0;0.0
20053607;284554;2;07.08.2023 00:00;52968;25234;27734;1.6
20053604;271399;2;08.08.2023 00:00;80089;66531;13558;4.3
20053603;271399;2;08.08.2023 00:00;77992;60482;17510;3.8
20053606;271400;2;09.08.2023 00:00;119349;105336;14013;6.7
20053605;271400;2;11.08.2023 00:00;68312;62498;5814;4.2
20054106;274789;2;11.08.2023 00:00;1412462;1290242;122220;83.1
20054412;274789;2;16.08.2023 00:00;1392120;1290244;101876;80.4
20054313;;2;20.08.2023 00:00;0;0;0;0.0
20054315;273720;2;20.08.2023 00:00;170821;142120;28701;9.7
20054314;;2;21.08.2023 00:00;0;0;0;0.0
20054353;268032;2;21.08.2023 00:00;110367;80448;29919;5.3
20054362;282346;2;22.08.2023 00:00;50515;40224;10291;2.6
20054359;279169;2;22.08.2023 00:00;261760;241344;20416;14.9
20054354;269893;2;22.08.2023 00:00;41803;40227;1576;2.5
20054361;280666;2;23.08.2023 00:00;41171;32258;8913;2.1
20054360;279898;2;23.08.2023 00:00;40002;32259;7743;2.0
20054352;267344;2;23.08.2023 00:00;37002;32258;4744;2.0
20054358;276788;2;23.08.2023 00:00;34798;31920;2878;2.0
20054356;271901;2;24.08.2023 00:00;41451;34360;7091;2.2
20054351;238762;2;24.08.2023 00:00;52094;35196;16898;2.3
20054355;271141;2;24.08.2023 00:00;11063;10058;1005;0.7
20054357;272043;2;24.08.2023 00:00;245008;221234;23774;14.4
20054451;284143;2;25.08.2023 00:00;66165;52362;13803;3.4
20054977;284904;2;25.08.2023 00:00;36434;36434;0;7.3
20054975;284904;2;26.08.2023 00:00;2900;2900;0;0.7
20054978;284904;2;26.08.2023 00:00;2900;2900;0;0.3
20054447;234093;2;26.08.2023 00:00;65008;43346;21662;2.8
20054540;279756;2;26.08.2023 00:00;220990;204338;16652;13.5
20054924;278577;2;27.08.2023 00:00;177501;173380;4121;10.9
20054591;278863;2;27.08.2023 00:00;214547;204339;10208;13.1
20054925;284948;2;27.08.2023 00:00;26532;21674;4858;1.5
20054590;241513;2;28.08.2023 00:00;242933;204336;38597;13.2
20054851;278355;2;29.08.2023 00:00;306619;294122;12497;18.9
20054847;234789;2;29.08.2023 00:00;25904;24770;1134;1.6
20054883;280357;2;30.08.2023 00:00;138566;123840;14726;8.1
20054850;277350;2;30.08.2023 00:00;155147;145515;9632;9.3
20054955;266275;2;31.08.2023 00:00;122729;114554;8175;7.4
20054959;285005;2;31.08.2023 00:00;53908;49538;4370;3.2
20054882;;2;31.08.2023 00:00;0;0;0;0.0
20055041;282832;2;31.08.2023 00:00;124189;106592;17597;6.8
20055042;283391;2;01.09.2023 00:00;121385;106592;14793;6.7
20055187;283389;2;01.09.2023 00:00;114450;106590;7860;6.8
20055040;273723;2;01.09.2023 00:00;276760;248712;28048;16.5
20055185;273723;2;03.09.2023 00:00;114379;106592;7787;6.7
20055189;283694;2;03.09.2023 00:00;186905;177650;9255;11.3
20055498;284604;2;03.09.2023 00:00;81487;71062;10425;4.9
20055497;273133;2;04.09.2023 00:00;108023;106592;1431;6.9
20055186;280966;2;04.09.2023 00:00;117668;106592;11076;7.0
20055038;;2;05.09.2023 00:00;0;0;0;0.0
20055072;265724;2;05.09.2023 00:00;58481;42786;15695;2.9
20055071;284845;2;05.09.2023 00:00;64670;45442;19228;3.0
20055405;250486;2;05.09.2023 00:00;122836;101762;21074;7.1
20055269;237788;2;06.09.2023 00:00;51096;32642;18454;2.2
20055270;239321;2;06.09.2023 00:00;70413;30721;39692;2.0
20055271;239322;2;07.09.2023 00:00;32647;30722;1925;2.1
20055276;284828;2;07.09.2023 00:00;10882;11522;-640;2.3
20055277;284829;2;07.09.2023 00:00;10882;10882;0;2.1
20055275;284222;2;07.09.2023 00:00;52942;25381;27561;1.6
20055274;283974;2;08.09.2023 00:00;54276;58322;-4046;3.9
20055499;;2;08.09.2023 00:00;0;0;0;0.0
20055291;284736;2;08.09.2023 00:00;26805;10253;16552;0.6
20055280;260373;2;08.09.2023 00:00;75553;50699;24854;3.3
20055283;280223;2;09.09.2023 00:00;29971;25140;4831;1.6
20055282;277198;2;09.09.2023 00:00;12621;10896;1725;0.9
20055691;268975;2;11.09.2023 00:00;174658;160898;13760;9.8
20055281;261524;2;11.09.2023 00:00;131736;102171;29565;6.7
20055279;252247;2;12.09.2023 00:00;127838;123842;3996;7.8
20055338;252143;2;12.09.2023 00:00;118399;102168;16231;6.4
20055339;277260;2;12.09.2023 00:00;42002;37154;4848;2.3
20055337;236237;2;13.09.2023 00:00;104127;102168;1959;6.6
20055406;282713;2;13.09.2023 00:00;147686;139322;8364;8.7
20055342;277258;2;13.09.2023 00:00;46870;43344;3526;2.6
20055458;234706;2;14.09.2023 00:00;440796;408672;32124;26.1
20055500;;2;15.09.2023 00:00;0;0;0;0.0
20055459;244550;2;15.09.2023 00:00;60160;61923;-1763;3.9
20055043;285066;2;15.09.2023 00:00;131947;103362;28585;6.7
20055044;285071;2;18.09.2023 00:00;131652;103362;28290;6.7
20055926;285267;2;19.09.2023 00:00;79863;63722;16141;4.2
20055278;;2;19.09.2023 00:00;0;0;0;0.0
20055922;279941;2;19.09.2023 00:00;31667;11340;20327;0.7
20055923;281829;2;19.09.2023 00:00;100025;102062;-2037;6.4
20055917;;2;21.09.2023 00:00;0;0;0;0.0
20055993;250493;2;22.09.2023 00:00;478330;408674;69656;25.3
20056083;259676;2;24.09.2023 00:00;159154;148610;10544;8.7
20056141;278355;2;24.09.2023 00:00;316357;303410;12947;18.8
20056145;279434;2;25.09.2023 00:00;123900;102168;21732;6.3
20056200;277256;2;26.09.2023 00:00;50370;37154;13216;2.2
20056199;254048;2;26.09.2023 00:00;68914;61920;6994;3.8
20056202;277261;2;26.09.2023 00:00;150052;148610;1442;9.0
20056201;277258;2;26.09.2023 00:00;45062;43344;1718;2.8
20056284;239280;2;27.09.2023 00:00;438357;408677;29680;25.1
20056285;276788;2;28.09.2023 00:00;47506;32594;14912;2.3
20056543;285161;2;29.09.2023 00:00;18485;10056;8429;0.7
20056304;284145;2;29.09.2023 00:00;87852;42840;45012;3.1
20056303;278030;2;29.09.2023 00:00;145431;133280;12151;8.7
20056383;275058;2;30.09.2023 00:00;101000;71061;29939;4.5
20056380;;2;30.09.2023 00:00;0;0;0;0.0
20056675;275320;2;30.09.2023 00:00;152819;142120;10699;9.2
20056385;283391;2;01.10.2023 00:00;128337;106590;21747;6.8
20056381;;2;01.10.2023 00:00;0;0;0;0.0
20056436;250490;2;01.10.2023 00:00;52873;38402;14471;2.5
20056435;250489;2;01.10.2023 00:00;55479;51203;4276;3.1
20056433;250487;2;02.10.2023 00:00;64941;55042;9899;3.4
20056432;250486;2;02.10.2023 00:00;119508;112642;6866;7.3
20056434;250488;2;02.10.2023 00:00;57002;50562;6440;3.3
20056575;281976;2;02.10.2023 00:00;39355;26883;12472;1.7
20056437;285307;2;03.10.2023 00:00;34172;26882;7290;1.9
20056429;;2;03.10.2023 00:00;0;0;0;0.0
20056506;277255;2;03.10.2023 00:00;125322;102170;23152;6.2
20056507;284000;2;03.10.2023 00:00;30002;21674;8328;1.3
20056503;236392;2;04.10.2023 00:00;119868;102170;17698;6.1
20056505;252247;2;04.10.2023 00:00;209701;188858;20843;11.5
20056501;234028;2;05.10.2023 00:00;214228;204341;9887;12.5
20056502;234028;2;05.10.2023 00:00;218984;204338;14646;12.9
20056504;251807;2;06.10.2023 00:00;229887;216722;13165;13.5
20056526;271281;2;06.10.2023 00:00;289168;257043;32125;16.0
20056525;272699;2;07.10.2023 00:00;173882;157082;16800;9.9
20056548;284143;2;08.10.2023 00:00;107994;80925;27069;5.0
20056546;282346;2;08.10.2023 00:00;54796;40224;14572;2.6
20056547;282871;2;09.10.2023 00:00;52286;32258;20028;2.0
20056545;271601;2;09.10.2023 00:00;30999;32258;-1259;1.9
20056544;266021;2;09.10.2023 00:00;34522;32258;2264;2.0
20056627;;2;09.10.2023 00:00;0;0;0;0.0
20056634;272719;2;09.10.2023 00:00;141200;106592;34608;7.0
20056636;283576;2;10.10.2023 00:00;400117;355302;44815;22.8
20056635;273723;2;11.10.2023 00:00;124800;106590;18210;6.8
20056720;273725;2;12.10.2023 00:00;150552;142122;8430;9.0
20056938;285071;2;12.10.2023 00:00;1210697;1111122;99575;68.5
20057162;283694;2;24.10.2023 00:00;108366;106592;1774;6.7
20057268;273133;2;24.10.2023 00:00;115261;106592;8669;6.7
20057270;283576;2;24.10.2023 00:00;114251;106592;7659;6.8
20057169;283389;2;25.10.2023 00:00;120065;106592;13473;6.4
20057170;283391;2;25.10.2023 00:00;152503;142122;10381;9.0
20057168;279851;2;26.10.2023 00:00;204751;177652;27099;11.0
20057693;273720;2;26.10.2023 00:00;113292;106592;6700;6.5
20057844;272412;2;27.10.2023 00:00;115283;110469;4814;6.9
20056628;;2;27.10.2023 00:00;0;0;0;0.0
20057291;236792;2;27.10.2023 00:00;46267;32258;14009;2.3
20057362;268453;2;28.10.2023 00:00;62414;40226;22188;3.1
20057360;266305;2;30.10.2023 00:00;46338;40226;6112;2.6
20057816;279169;2;30.10.2023 00:00;222420;201122;21298;12.7
20057364;270852;2;30.10.2023 00:00;44683;40227;4456;2.6
20057363;269893;2;31.10.2023 00:00;93923;80450;13473;4.9
20057366;282346;2;31.10.2023 00:00;98011;80450;17561;5.2
20057365;281111;2;31.10.2023 00:00;43002;40226;2776;2.3
20057408;268274;2;31.10.2023 00:00;122315;120676;1639;7.6
20057387;268032;2;01.11.2023 00:00;94989;80450;14539;4.9
20057614;268975;2;01.11.2023 00:00;357345;321794;35551;20.9
20057613;262323;2;02.11.2023 00:00;30702;21674;9028;1.4
20057837;278577;2;02.11.2023 00:00;134019;123842;10177;7.7
20057662;252247;2;03.11.2023 00:00;152897;139322;13575;8.6
20057692;280357;2;03.11.2023 00:00;165844;148610;17234;9.5
20057663;277259;2;04.11.2023 00:00;337106;306506;30600;19.1
20057722;279755;2;06.11.2023 00:00;339582;306506;33076;18.9
20057978;236237;2;07.11.2023 00:00;118376;102168;16208;6.4
20057986;241154;2;08.11.2023 00:00;76918;61925;14993;4.0
20057979;259089;2;08.11.2023 00:00;35000;30960;4040;2.0
20057982;235286;2;08.11.2023 00:00;128290;123842;4448;7.7
20057985;237362;2;08.11.2023 00:00;63127;55730;7397;3.6
20057984;236631;2;09.11.2023 00:00;36464;30963;5501;2.0
20057981;234094;2;09.11.2023 00:00;44002;37154;6848;2.5
20057988;244727;2;09.11.2023 00:00;273381;256970;16411;15.7
20058091;266335;2;10.11.2023 00:00;251698;235298;16400;14.5
20058092;278863;2;10.11.2023 00:00;226397;204338;22059;12.8
20058238;;2;13.11.2023 00:00;0;0;0;0.0
20058257;236435;2;13.11.2023 00:00;47996;43883;4113;2.9
20058256;236211;2;13.11.2023 00:00;38607;21942;16665;1.5
20058330;275872;2;13.11.2023 00:00;49529;43883;5646;2.8
20058255;235745;2;13.11.2023 00:00;26002;21942;4060;1.5
20058258;249053;2;14.11.2023 00:00;111519;87762;23757;5.6
20058251;270683;2;14.11.2023 00:00;178535;163842;14693;10.3
20058287;285609;2;15.11.2023 00:00;69152;50353;18799;3.2
20058340;283917;2;15.11.2023 00:00;283743;282242;1501;17.3
20058341;283917;2;16.11.2023 00:00;299906;282242;17664;17.6
20058239;;2;17.11.2023 00:00;0;0;0;0.0
20058419;283391;2;17.11.2023 00:00;189320;142122;47198;8.8
20058462;273720;2;20.11.2023 00:00;168968;142122;26846;10.0
20058463;273723;2;21.11.2023 00:00;116422;106592;9830;6.9
20058465;273133;2;22.11.2023 00:00;119466;106590;12876;7.0
20058464;279851;2;22.11.2023 00:00;160390;142122;18268;9.4
20058443;;2;23.11.2023 00:00;0;0;0;0.0
20058444;249831;2;23.11.2023 00:00;169197;95204;73993;8.0
20058571;285399;2;24.11.2023 00:00;708536;598684;109852;41.0
20058606;271872;2;28.11.2023 00:00;100111;92162;7949;5.7
20058602;285375;2;28.11.2023 00:00;537276;506884;30392;31.2
20058684;264643;2;30.11.2023 00:00;203967;184322;19645;11.5
20058920;279169;2;30.11.2023 00:00;362513;321794;40719;20.2
20058760;285923;2;01.12.2023 00:00;225930;201122;24808;12.5
20058570;285579;2;02.12.2023 00:00;69752;57786;11966;4.2
20058572;285758;2;02.12.2023 00:00;932;932;0;3.5
20059388;234706;2;03.12.2023 00:00;255089;204338;50751;13.0
20059032;280357;2;03.12.2023 00:00;338475;321986;16489;19.5
20059027;259676;2;04.12.2023 00:00;194198;173378;20820;10.7
20058862;277261;2;05.12.2023 00:00;237569;222914;14655;13.5
20059387;238904;2;05.12.2023 00:00;44952;43346;1606;2.7
20059329;234028;2;06.12.2023 00:00;212576;204338;8238;12.1
20059504;286156;2;07.12.2023 00:00;23220;23220;0;9.5
20059025;252143;2;07.12.2023 00:00;313271;303410;9861;18.5
20059292;279757;2;08.12.2023 00:00;227678;198149;29529;11.8
20058460;237611;2;13.12.2023 00:00;55738;43346;12392;2.6
20059332;278577;2;13.12.2023 00:00;126340;127713;-1373;7.8
20059331;239383;2;14.12.2023 00:00;36202;30962;5240;1.9
20058461;237781;2;14.12.2023 00:00;45796;43346;2450;2.6
20059031;278280;2;14.12.2023 00:00;121026;102170;18856;6.4
20059330;234789;2;14.12.2023 00:00;55002;52634;2368;3.4
20059328;233776;2;14.12.2023 00:00;113917;102171;11746;6.2
20059487;236915;2;15.12.2023 00:00;116661;95978;20683;5.7
20059508;285399;2;15.12.2023 00:00;363448;322562;40886;20.1
20059486;234093;2;15.12.2023 00:00;48088;43346;4742;2.8
20059492;284002;2;15.12.2023 00:00;26002;24770;1232;1.6
20059543;285375;2;18.12.2023 00:00;500228;460802;39426;28.4
20059684;285852;2;20.12.2023 00:00;42200;28562;13638;1.8
20059683;283915;2;20.12.2023 00:00;51182;40226;10956;2.5
20059679;249972;2;20.12.2023 00:00;43512;40226;3286;2.5
20059682;279690;2;20.12.2023 00:00;31042;27237;3805;1.7
20059680;260373;2;21.12.2023 00:00;63736;58243;5493;3.4
20059817;264085;2;21.12.2023 00:00;109670;100802;8868;6.5
20059681;276788;2;21.12.2023 00:00;41616;32258;9358;2.0
20059819;267344;2;21.12.2023 00:00;37026;32258;4768;2.0
20059818;267344;2;21.12.2023 00:00;33952;32258;1694;2.0
20059696;282871;2;21.12.2023 00:00;40437;32258;8179;2.0
20059820;283868;2;22.12.2023 00:00;39517;32261;7256;2.0
20059869;285267;2;22.12.2023 00:00;153601;135002;18599;8.3
20059862;;2;22.12.2023 00:00;0;0;0;0.0
20059868;283230;2;23.12.2023 00:00;12931;13503;-572;0.7
20059900;285711;2;23.12.2023 00:00;29274;25602;3672;1.5
20059955;283735;2;03.01.2024 00:00;24275;28160;-3885;1.6
20059867;269346;2;03.01.2024 00:00;36632;35842;790;2.2
20059866;258958;2;03.01.2024 00:00;49465;30720;18745;2.5
20059865;237788;2;03.01.2024 00:00;43286;30720;12566;2.1
20059863;;2;04.01.2024 00:00;0;0;0;0.0
20059957;271281;2;04.01.2024 00:00;243297;214202;29095;13.1
20059954;271999;2;04.01.2024 00:00;36712;26180;10532;1.6
20059953;269343;2;05.01.2024 00:00;29000;26180;2820;1.6
20059871;256199;2;05.01.2024 00:00;80660;65019;15641;3.8
20059952;227144;2;05.01.2024 00:00;28000;26180;1820;1.6
20059870;234706;2;05.01.2024 00:00;433859;408674;25185;24.5
20059883;234704;2;08.01.2024 00:00;170511;145514;24997;9.2
20059980;266275;2;08.01.2024 00:00;90343;89786;557;5.3
20059978;244962;2;09.01.2024 00:00;65781;49538;16243;3.0
20059982;279589;2;09.01.2024 00:00;114020;102170;11850;6.2
20059979;257340;2;09.01.2024 00:00;127393;123842;3551;7.4
20060024;237576;2;10.01.2024 00:00;142327;126938;15389;7.6
20060023;236237;2;10.01.2024 00:00;220587;204336;16251;12.7
20060061;277261;2;11.01.2024 00:00;305281;272450;32831;16.8
20060149;;2;12.01.2024 00:00;0;0;0;0.0
20060057;238802;2;12.01.2024 00:00;25900;24768;1132;1.7
20060154;273720;2;12.01.2024 00:00;247393;213182;34211;13.4
20060153;273133;2;13.01.2024 00:00;81029;71062;9967;4.4
20060156;283389;2;15.01.2024 00:00;135662;106592;29070;6.8
20060157;283391;2;15.01.2024 00:00;72538;71064;1474;4.5
20060152;269494;2;16.01.2024 00:00;222897;213182;9715;13.4
20060438;286003;2;17.01.2024 00:00;569581;532952;36629;32.8
20060666;286373;2;18.01.2024 00:00;150403;142122;8281;8.9
20060439;286308;2;19.01.2024 00:00;116141;106590;9551;6.4
20060612;282832;2;19.01.2024 00:00;364015;319772;44243;19.5
20060815;286377;2;22.01.2024 00:00;160304;142120;18184;8.9
20060814;286375;2;23.01.2024 00:00;170793;142122;28671;8.8
20060813;286374;2;23.01.2024 00:00;148471;142122;6349;8.5
20060150;;2;24.01.2024 00:00;0;0;0;0.0
20060059;283915;2;24.01.2024 00:00;67668;40227;27441;2.5
20060058;268453;2;24.01.2024 00:00;48636;40226;8410;2.5
20060060;285923;2;25.01.2024 00:00;175862;160898;14964;10.3
20060064;279169;2;25.01.2024 00:00;265442;241346;24096;15.0
20060141;268975;2;26.01.2024 00:00;237535;201122;36413;12.3
20060424;271601;2;27.01.2024 00:00;43935;32258;11677;2.1
20060140;267344;2;29.01.2024 00:00;40697;32258;8439;2.0
20060826;266480;2;29.01.2024 00:00;57821;48720;9101;2.9
20060585;239383;2;29.01.2024 00:00;45069;30960;14109;2.0
20060470;257462;2;29.01.2024 00:00;38002;34058;3944;2.2
20060468;236666;2;29.01.2024 00:00;69696;65018;4678;3.9
20060472;279590;2;30.01.2024 00:00;221811;204338;17473;12.4
20060469;243758;2;30.01.2024 00:00;26002;21674;4328;1.3
20060583;234578;2;30.01.2024 00:00;175413;167186;8227;10.0
20060586;250493;2;31.01.2024 00:00;443474;408674;34800;24.9
20060891;279434;2;01.02.2024 00:00;214824;204339;10485;12.4
20060886;234028;2;02.02.2024 00:00;317855;291026;26829;17.5
20060960;284948;2;03.02.2024 00:00;52921;49538;3383;3.2
20061214;274440;2;05.02.2024 00:00;23992;21674;2318;1.3
20061215;278355;2;05.02.2024 00:00;239584;222914;16670;13.4
20061574;286583;2;05.02.2024 00:00;5754;5754;0;6.3
20060994;285772;2;06.02.2024 00:00;109113;95902;13211;8.9
20061573;286584;2;06.02.2024 00:00;1866;1866;0;10.0
20061078;285579;2;07.02.2024 00:00;178183;160336;17847;10.5
20061433;;2;07.02.2024 00:00;0;0;0;0.0
20061446;286373;2;08.02.2024 00:00;285335;248712;36623;15.1
20061451;286375;2;09.02.2024 00:00;157939;142122;15817;9.0
20061649;286680;2;09.02.2024 00:00;148896;142122;6774;9.2
20061452;286377;2;10.02.2024 00:00;350318;319772;30546;19.5
20061434;;2;12.02.2024 00:00;0;0;0;0.0
20061443;272043;2;13.02.2024 00:00;93529;70817;22712;4.5
20061442;272043;2;13.02.2024 00:00;62002;60338;1664;3.6
20061438;260524;2;13.02.2024 00:00;12748;10058;2690;0.7
20061444;285243;2;13.02.2024 00:00;338745;303482;35263;18.7
20061441;271901;2;13.02.2024 00:00;11002;10058;944;0.7
20061588;279756;2;14.02.2024 00:00;332351;306506;25845;18.8
20061585;237781;2;15.02.2024 00:00;52989;49538;3451;3.0
20061587;254048;2;15.02.2024 00:00;75345;61922;13423;3.9
20061584;237427;2;16.02.2024 00:00;94593;86690;7903;5.5
20061596;278863;2;16.02.2024 00:00;213461;204338;9123;12.2
20061586;241513;2;16.02.2024 00:00;293304;278644;14660;16.7
20061602;279949;2;19.02.2024 00:00;64912;61922;2990;3.7
20061598;254050;2;19.02.2024 00:00;74488;61923;12565;3.8
20061741;239082;2;19.02.2024 00:00;233706;204338;29368;12.7
20061740;236915;2;20.02.2024 00:00;167316;154802;12514;9.6
20061875;268274;2;21.02.2024 00:00;138757;120674;18083;7.1
20061870;266305;2;21.02.2024 00:00;44418;40227;4191;2.6
20061871;268453;2;21.02.2024 00:00;42680;40226;2454;2.4
20061908;286662;2;21.02.2024 00:00;168306;142122;26184;8.8
20061906;;2;21.02.2024 00:00;0;0;0;0.0
20062164;286375;2;22.02.2024 00:00;120059;106592;13467;6.7
20062165;286375;2;22.02.2024 00:00;146233;142122;4111;8.7
20061909;286682;2;23.02.2024 00:00;166891;142122;24769;8.7
20061969;286680;2;23.02.2024 00:00;299829;284242;15587;17.5
20062163;286003;2;26.02.2024 00:00;370781;355302;15479;21.2
20062531;286003;2;27.02.2024 00:00;114372;106592;7780;6.6
20061910;286683;2;27.02.2024 00:00;260212;248712;11500;14.9
20062166;;2;28.02.2024 00:00;0;0;0;0.0
20062207;286591;2;28.02.2024 00:00;6;6;0;3.5
20062433;275984;2;29.02.2024 00:00;55971;33554;22417;2.1
20062432;274088;2;29.02.2024 00:00;356217;301682;54535;19.2
20062434;275987;2;29.02.2024 00:00;35701;33554;2147;2.1
20062436;277258;2;01.03.2024 00:00;89068;61922;27146;3.9
20062435;277256;2;02.03.2024 00:00;78268;74306;3962;4.4
20062473;237611;2;02.03.2024 00:00;46002;40251;5751;2.4
20062479;277259;2;04.03.2024 00:00;217936;204338;13598;12.3
20062480;279757;2;04.03.2024 00:00;167705;148610;19095;8.8
20062514;235286;2;05.03.2024 00:00;140320;123842;16478;7.6
20062595;282713;2;06.03.2024 00:00;180804;167186;13618;9.9
20062594;266335;2;06.03.2024 00:00;178580;164864;13716;10.0
20062711;278355;2;07.03.2024 00:00;338042;322760;15282;19.3
20062593;259676;2;08.03.2024 00:00;373164;348304;24860;20.7
20062742;280357;2;09.03.2024 00:00;730444;594436;136008;36.8
20062737;234830;2;11.03.2024 00:00;55659;49538;6121;2.9
20062738;257342;2;12.03.2024 00:00;107655;102170;5485;6.1
20062741;278280;2;12.03.2024 00:00;114282;102170;12112;6.1
20062785;234706;2;12.03.2024 00:00;561529;513938;47591;30.9
20062917;279755;2;14.03.2024 00:00;330471;306507;23964;18.6
20062916;249831;2;15.03.2024 00:00;172470;120746;51724;8.7
20062918;;2;16.03.2024 00:00;0;0;0;0.0
20062922;286650;2;16.03.2024 00:00;41914;26880;15034;2.0
20062920;250489;2;16.03.2024 00:00;33003;20481;12522;1.2
20062921;250490;2;16.03.2024 00:00;20737;20480;257;1.2
20062973;250487;2;16.03.2024 00:00;19000;17921;1079;1.6
20062974;250488;2;16.03.2024 00:00;13403;10240;3163;1.0
20062972;250486;2;17.03.2024 00:00;133000;131200;1800;9.0
20062975;284546;2;17.03.2024 00:00;43149;28160;14989;2.7
20062919;;2;17.03.2024 00:00;0;0;0;0.0
20062978;275058;2;18.03.2024 00:00;98903;71062;27841;4.6
20063029;275320;2;18.03.2024 00:00;386870;355302;31568;22.0
20063105;273720;2;19.03.2024 00:00;357812;319772;38040;19.8
20062976;;2;20.03.2024 00:00;0;0;0;0.0
20063077;276788;2;21.03.2024 00:00;43622;32258;11364;2.0
20063076;266480;2;21.03.2024 00:00;46254;32260;13994;2.0
20063119;266480;2;21.03.2024 00:00;67684;64514;3170;4.1
20063120;276704;2;21.03.2024 00:00;36002;32258;3744;2.0
20063384;286909;2;21.03.2024 00:00;101351;96770;4581;6.0
20063191;279898;2;21.03.2024 00:00;38003;32259;5744;2.0
20063188;260373;2;22.03.2024 00:00;63186;60338;2848;3.9
20063210;279169;2;22.03.2024 00:00;260771;241346;19425;14.4
20063193;284143;2;23.03.2024 00:00;76350;52363;23987;3.4
20063189;278030;2;23.03.2024 00:00;109023;76162;32861;5.0
20063194;286173;2;23.03.2024 00:00;135364;92164;43200;6.7
20063300;285375;2;25.03.2024 00:00;481840;460806;21034;27.5
20063382;286841;2;26.03.2024 00:00;153497;138242;15255;8.7
20063383;286894;2;27.03.2024 00:00;109186;92163;17023;5.5
20063386;277350;2;27.03.2024 00:00;77746;58826;18920;3.8
20063476;252143;2;28.03.2024 00:00;226309;204339;21970;12.1
20063385;277260;2;28.03.2024 00:00;60738;58826;1912;3.8
20063481;279590;2;03.04.2024 00:00;150118;148610;1508;8.9
20063840;237762;2;04.04.2024 00:00;56012;46440;9572;2.8
20063622;241154;2;04.04.2024 00:00;118533;105266;13267;6.4
20063677;234706;2;04.04.2024 00:00;433664;408672;24992;24.8
20063676;234705;2;04.04.2024 00:00;46380;43346;3034;2.7
20063846;277259;2;06.04.2024 00:00;337025;306504;30521;18.6
20063841;238904;2;07.04.2024 00:00;78560;46440;32120;3.0
20063848;285005;2;07.04.2024 00:00;40600;30960;9640;2.2
20063847;280190;2;07.04.2024 00:00;84890;71209;13681;4.7
20063845;261524;2;07.04.2024 00:00;104143;99074;5069;6.2
20063844;254918;2;08.04.2024 00:00;33852;24771;9081;1.5
20063842;239280;2;08.04.2024 00:00;217366;204338;13028;12.4
20063843;244550;2;08.04.2024 00:00;64783;61922;2861;3.9
20063859;281317;2;09.04.2024 00:00;56327;40251;16076;2.6
20063914;278577;2;09.04.2024 00:00;264616;247682;16934;14.7
20064097;286927;2;10.04.2024 00:00;455873;386285;69588;23.1
20064086;280080;2;12.04.2024 00:00;46396;36362;10034;2.3
20064078;;2;12.04.2024 00:00;0;0;0;0.0
20064102;286591;2;12.04.2024 00:00;24592;24592;0;9.8
20064094;285764;2;12.04.2024 00:00;154857;100658;54199;7.1
20064092;282993;2;15.04.2024 00:00;44862;41010;3852;2.8
20064093;282993;2;15.04.2024 00:00;64592;58718;5874;4.1
20064090;282987;2;15.04.2024 00:00;54237;41010;13227;2.8
20064091;282987;2;16.04.2024 00:00;67370;66175;1195;4.6
20064084;272736;2;16.04.2024 00:00;65170;55922;9248;3.3
20064081;269066;2;16.04.2024 00:00;52456;46602;5854;2.9
20064320;286931;2;16.04.2024 00:00;16133;16133;0;5.2
20064085;272736;2;16.04.2024 00:00;57986;55922;2064;3.4
20064083;270855;2;17.04.2024 00:00;15519;15519;0;6.2
20064080;241023;2;17.04.2024 00:00;57797;44736;13061;3.3
20064095;286029;2;17.04.2024 00:00;13888;13888;0;3.6
20064087;281014;2;18.04.2024 00:00;108692;78077;30615;5.7
20064088;281017;2;18.04.2024 00:00;93077;95976;-2899;6.4
20064079;237788;2;19.04.2024 00:00;90165;51202;38963;3.2
20064089;281021;2;19.04.2024 00:00;36000;31734;4266;2.3
20064076;;2;19.04.2024 00:00;0;0;0;0.0
20064096;286650;2;19.04.2024 00:00;37295;27521;9774;2.0
20064082;269346;2;19.04.2024 00:00;30168;25602;4566;1.6
20064706;286184;2;20.04.2024 00:00;181281;140402;40879;10.8
20064077;;2;22.04.2024 00:00;0;0;0;0.0
20064400;287032;2;23.04.2024 00:00;21861;21861;0;6.5
20064398;286683;2;23.04.2024 00:00;126002;106592;19410;7.1
20064396;286377;2;24.04.2024 00:00;116507;106594;9913;6.7
20064397;286680;2;24.04.2024 00:00;117561;106592;10969;6.9
20064494;287058;2;24.04.2024 00:00;118784;106592;12192;6.6
20064447;286308;2;25.04.2024 00:00;118007;106593;11414;6.8
20065274;287337;2;25.04.2024 00:00;116702;103362;13340;6.3
20065275;287342;2;26.04.2024 00:00;164018;155042;8976;9.7
20064490;264643;2;26.04.2024 00:00;168144;138242;29902;8.1
20064458;;2;26.04.2024 00:00;0;0;0;0.0
20064553;277951;2;29.04.2024 00:00;64479;57602;6877;3.7
20064555;286841;2;29.04.2024 00:00;232325;207362;24963;12.8
20064554;285399;2;30.04.2024 00:00;350240;322562;27678;19.8
20065469;264643;2;01.05.2024 00:00;69116;54724;14392;3.5
20065470;277951;2;01.05.2024 00:00;65055;57960;7095;3.6
20064944;272699;2;01.05.2024 00:00;231122;214202;16920;13.0
20064638;269893;2;02.05.2024 00:00;173030;160898;12132;9.7
20064640;273854;2;02.05.2024 00:00;45502;40226;5276;2.5
20064642;283915;2;03.05.2024 00:00;47702;40226;7476;2.4
20064692;284143;2;03.05.2024 00:00;40599;28562;12037;1.7
20064691;260373;2;03.05.2024 00:00;72295;55310;16985;3.4
20064850;286935;2;03.05.2024 00:00;37705;32259;5446;2.0
20065507;277198;2;03.05.2024 00:00;17002;15086;1916;0.9
20065508;280223;2;03.05.2024 00:00;40002;38969;1033;2.3
20064847;267344;2;04.05.2024 00:00;35688;32258;3430;2.0
20065081;;2;06.05.2024 00:00;0;0;0;0.0
20065087;286860;2;06.05.2024 00:00;94417;77222;17195;4.9
20065086;286712;2;06.05.2024 00:00;32002;27002;5000;1.7
20065493;287481;2;06.05.2024 00:00;34402;27002;7400;1.8
20065083;266175;2;06.05.2024 00:00;289503;264042;25461;16.6
20065084;271399;2;07.05.2024 00:00;44798;32259;12539;1.8
20065085;271400;2;07.05.2024 00:00;44512;43346;1166;2.7
20065088;287282;2;07.05.2024 00:00;36187;30719;5468;2.0
20065082;;2;08.05.2024 00:00;0;0;0;0.0
20064943;244727;2;08.05.2024 00:00;127589;99074;28515;6.5
20065047;244962;2;08.05.2024 00:00;55910;46443;9467;3.2
20065049;254050;2;08.05.2024 00:00;48288;43346;4942;2.8
20065048;252247;2;09.05.2024 00:00;280923;253874;27049;16.0
20065502;287292;2;13.05.2024 00:00;28502;24770;3732;1.4
20065501;287212;2;13.05.2024 00:00;28502;24770;3732;1.6
20065537;233776;2;13.05.2024 00:00;102712;89786;12926;5.6
20065541;278863;2;13.05.2024 00:00;545622;510842;34780;30.5
20065605;278355;2;15.05.2024 00:00;407977;387002;20975;23.2
20065682;278355;2;16.05.2024 00:00;329680;309602;20078;18.7
20065707;236237;2;17.05.2024 00:00;110963;102170;8793;6.3
20065708;237576;2;17.05.2024 00:00;114486;102169;12317;6.3
20065747;234789;2;17.05.2024 00:00;73575;65018;8557;4.0
20065749;278577;2;18.05.2024 00:00;223446;198146;25300;12.8
20065748;266335;2;20.05.2024 00:00;175417;173378;2039;10.3
20065752;;2;21.05.2024 00:00;0;0;0;0.0
20065753;286683;2;21.05.2024 00:00;215366;177652;37714;11.0
20065882;287552;2;21.05.2024 00:00;118965;103361;15604;6.4
20065881;287549;2;22.05.2024 00:00;137981;129202;8779;8.2
20066260;287586;2;22.05.2024 00:00;82085;77520;4565;4.6
20066261;287778;2;23.05.2024 00:00;29500;27160;2340;1.7
20065862;275320;2;23.05.2024 00:00;109128;130494;-21366;6.6
20065939;273720;2;23.05.2024 00:00;152446;142122;10324;8.6
20065951;273720;2;23.05.2024 00:00;152982;142122;10860;8.8
20065953;287058;2;24.05.2024 00:00;196247;177652;18595;10.6
20066119;287724;2;25.05.2024 00:00;181801;177650;4151;10.7
20065950;;2;25.05.2024 00:00;0;0;0;0.0
20066503;287542;2;25.05.2024 00:00;101491;79268;22223;5.2
20066264;;2;26.05.2024 00:00;0;0;0;0.0
20066030;277255;2;26.05.2024 00:00;119388;102168;17220;6.1
20066055;278280;2;26.05.2024 00:00;108001;102173;5828;6.4
20066054;277259;2;26.05.2024 00:00;226568;204336;22232;12.6
20066053;251807;2;27.05.2024 00:00;187455;173378;14077;10.7
20066051;234028;2;28.05.2024 00:00;355939;321986;33953;19.8
20066052;234706;2;29.05.2024 00:00;645194;613011;32183;36.8
20066146;264012;2;30.05.2024 00:00;32158;24770;7388;1.6
20066651;277261;2;31.05.2024 00:00;265736;247680;18056;14.7
20066147;285375;2;31.05.2024 00:00;788374;737282;51092;45.4
20066148;286894;2;03.06.2024 00:00;101116;92162;8954;5.9
20066224;285923;2;03.06.2024 00:00;142923;120674;22249;7.2
20066327;266305;2;03.06.2024 00:00;52053;40226;11827;2.4
20066372;284143;2;04.06.2024 00:00;80439;52363;28076;3.1
20066373;284145;2;04.06.2024 00:00;41208;28562;12646;1.7
20066329;283915;2;04.06.2024 00:00;40607;40226;381;2.6
20066370;275246;2;04.06.2024 00:00;146958;104720;42238;6.3
20066369;260373;2;05.06.2024 00:00;78492;61595;16897;3.8
20066376;287291;2;05.06.2024 00:00;14826;14280;546;0.8
20066375;287290;2;05.06.2024 00:00;16340;14280;2060;0.9
20066371;276788;2;05.06.2024 00:00;80246;64514;15732;3.9
20066374;286152;2;05.06.2024 00:00;143216;128688;14528;7.7
20066429;253693;2;06.06.2024 00:00;33502;32258;1244;2.3
20066433;267344;2;06.06.2024 00:00;33002;32258;744;2.3
20066436;274448;2;06.06.2024 00:00;67109;64514;2595;3.9
20066430;262255;2;06.06.2024 00:00;34802;26180;8622;1.6
20066435;271999;2;07.06.2024 00:00;35116;26182;8934;1.7
20066432;265102;2;07.06.2024 00:00;34000;28560;5440;2.0
20066431;264369;2;07.06.2024 00:00;32000;26180;5820;1.9
20066437;285137;2;07.06.2024 00:00;305442;253442;52000;15.6
20066427;200466;2;08.06.2024 00:00;16702;11186;5516;0.7
20066434;270855;2;08.06.2024 00:00;113406;93203;20203;6.1
20066428;200470;2;08.06.2024 00:00;14292;11186;3106;0.7
20066536;;2;08.06.2024 00:00;0;0;0;0.0
20066535;;2;09.06.2024 00:00;0;0;0;0.0
20066781;286003;2;09.06.2024 00:00;181929;164732;17197;8.9
20066540;286683;2;09.06.2024 00:00;113835;106592;7243;6.4
20066538;286377;2;10.06.2024 00:00;118442;106590;11852;6.5
20066539;286682;2;10.06.2024 00:00;121427;106502;14925;6.8
20066620;286374;2;11.06.2024 00:00;114462;106590;7872;6.5
20066778;287058;2;11.06.2024 00:00;379869;355300;24569;22.0
20066775;286375;2;12.06.2024 00:00;112105;106592;5513;6.3
20066864;287920;2;12.06.2024 00:00;36530;25925;10605;1.7
20066780;;2;12.06.2024 00:00;0;0;0;0.0
20066858;286257;2;13.06.2024 00:00;57350;43740;13610;2.7
20066865;287921;2;13.06.2024 00:00;52518;30782;21736;1.9
20066859;286708;2;13.06.2024 00:00;77263;72902;4361;4.3
20066861;286885;2;13.06.2024 00:00;41502;38882;2620;2.3
20066860;286779;2;13.06.2024 00:00;39524;43202;-3678;2.8
20066922;282131;2;14.06.2024 00:00;213873;192866;21007;11.6
20066923;282227;2;14.06.2024 00:00;15602;13778;1824;0.8
20066933;282129;2;14.06.2024 00:00;52302;41331;10971;2.6
20066934;282232;2;15.06.2024 00:00;21702;20666;1036;1.4
20066935;282233;2;15.06.2024 00:00;23560;20666;2894;1.5
20066921;281554;2;15.06.2024 00:00;37915;34443;3472;2.0
20066932;281556;2;15.06.2024 00:00;35502;34442;1060;2.0
20066931;272320;2;15.06.2024 00:00;32957;26880;6077;1.6
20066936;287837;2;15.06.2024 00:00;44153;26880;17273;1.7
20066942;263774;2;16.06.2024 00:00;55012;53762;1250;3.3
20066944;271283;2;16.06.2024 00:00;47160;40322;6838;2.8
20066948;286265;2;16.06.2024 00:00;10629;2521;8108;0.2
20066946;272319;2;16.06.2024 00:00;56002;53762;2240;3.2
20066945;271286;2;16.06.2024 00:00;28002;26882;1120;1.7
20066949;286267;2;16.06.2024 00:00;43413;33602;9811;1.9
20066950;286267;2;17.06.2024 00:00;2500;3360;-860;0.2
20067515;271283;2;17.06.2024 00:00;51929;53760;-1831;3.2
20066972;271399;2;17.06.2024 00:00;40748;11088;29660;0.6
20066975;271400;2;17.06.2024 00:00;34822;41330;-6508;2.0
20066973;281977;2;18.06.2024 00:00;93040;92162;878;5.7
20066971;258958;2;18.06.2024 00:00;44251;25600;18651;1.6
20066974;;2;19.06.2024 00:00;0;0;0;0.0
20066970;237788;2;19.06.2024 00:00;31027;30722;305;2.0
20067012;272699;2;19.06.2024 00:00;239417;214202;25215;12.8
20067010;268975;2;19.06.2024 00:00;347416;321794;25622;19.3
20067704;286847;2;20.06.2024 00:00;158926;138272;20654;8.6
20067020;286909;2;21.06.2024 00:00;39982;32259;7723;1.9
20067703;286880;2;21.06.2024 00:00;15204;10058;5146;0.6
20067702;286849;2;21.06.2024 00:00;22694;21792;902;1.3
20067013;276788;2;21.06.2024 00:00;38204;32258;5946;2.0
20067011;271601;2;21.06.2024 00:00;36002;32258;3744;1.9
20067015;277350;2;22.06.2024 00:00;81788;65018;16770;3.9
20067014;277260;2;22.06.2024 00:00;77002;74306;2696;4.6
20067008;236237;2;22.06.2024 00:00;103725;99074;4651;5.9
20067009;236666;2;22.06.2024 00:00;56329;40248;16081;2.3
20067121;278355;2;23.06.2024 00:00;424430;408674;15756;25.3
20067016;284000;2;23.06.2024 00:00;23000;21672;1328;1.3
20067251;237362;2;24.06.2024 00:00;46380;37154;9226;2.3
20067254;287548;2;24.06.2024 00:00;26002;24770;1232;1.6
20067312;234094;2;24.06.2024 00:00;39202;37154;2048;2.2
20067315;266275;2;24.06.2024 00:00;197089;185762;11327;11.2
20067314;239383;2;25.06.2024 00:00;33002;30962;2040;2.0
20067362;262323;2;25.06.2024 00:00;31358;24771;6587;1.6
20067363;283225;2;25.06.2024 00:00;27954;24770;3184;1.6
20067361;257340;2;25.06.2024 00:00;141576;133130;8446;8.2
20067360;250493;2;26.06.2024 00:00;220964;204338;16626;12.3
20067473;237611;2;26.06.2024 00:00;54500;49537;4963;2.9
20067476;279755;2;27.06.2024 00:00;218463;204338;14125;12.0
20067474;259676;2;27.06.2024 00:00;215141;198146;16995;12.3
20067472;234830;2;28.06.2024 00:00;56605;61922;-5317;3.7
20067475;271281;2;28.06.2024 00:00;228941;215391;13550;13.0
20067519;286780;2;29.06.2024 00:00;77439;26098;51341;2.1
20067516;260343;2;29.06.2024 00:00;43852;27960;15892;1.7
20067535;281014;2;30.06.2024 00:00;37924;29827;8097;1.8
20067518;286780;2;30.06.2024 00:00;27102;26098;1004;1.6
20067536;282309;2;30.06.2024 00:00;70030;52194;17836;3.3
20067647;282308;2;30.06.2024 00:00;121354;114638;6716;7.0
20067646;272734;2;01.07.2024 00:00;33674;27964;5710;1.7
20067863;285197;2;01.07.2024 00:00;11925;11186;739;0.7
20067537;285197;2;01.07.2024 00:00;19002;17710;1292;1.1
20067533;;2;01.07.2024 00:00;0;0;0;0.0
20067648;287058;2;01.07.2024 00:00;381056;319770;61286;19.8
20068069;;2;01.07.2024 00:00;0;0;0;0.0
20066621;287058;2;02.07.2024 00:00;187401;177652;9749;10.9
20067738;287342;2;03.07.2024 00:00;112808;103360;9448;6.2
20067793;249831;2;03.07.2024 00:00;303330;241490;61840;18.7
20067534;;2;03.07.2024 00:00;0;0;0;0.0
20067796;278030;2;05.07.2024 00:00;136951;104723;32228;6.4
20067795;275246;2;06.07.2024 00:00;114808;104722;10086;6.6
20067798;285923;2;06.07.2024 00:00;137285;120674;16611;7.3
20067797;283915;2;06.07.2024 00:00;50309;40224;10085;2.4
20067968;279169;2;07.07.2024 00:00;244658;241346;3312;14.4
20067794;266305;2;07.07.2024 00:00;50207;40224;9983;2.5
20067859;274474;2;07.07.2024 00:00;41365;32257;9108;2.0
20067858;254048;2;08.07.2024 00:00;57685;43346;14339;2.4
20067965;250535;2;08.07.2024 00:00;45802;43346;2456;2.6
20067964;250188;2;08.07.2024 00:00;38044;43346;-5302;2.6
20067966;252143;2;08.07.2024 00:00;71990;61920;10070;3.6
20067969;281864;2;08.07.2024 00:00;46002;43346;2656;2.5
20067963;244727;2;09.07.2024 00:00;266130;257744;8386;15.5
20067967;278863;2;09.07.2024 00:00;647955;613010;34945;37.9
20067962;243758;2;11.07.2024 00:00;25244;21674;3570;1.3
20067961;235286;2;12.07.2024 00:00;138976;123842;15134;7.4
20068011;285399;2;12.07.2024 00:00;495689;460802;34887;28.1
20068432;;2;13.07.2024 00:00;0;0;0;0.0
20068435;287872;2;14.07.2024 00:00;184845;106594;78251;6.7
20068433;;2;15.07.2024 00:00;0;0;0;0.0
20068708;288126;2;15.07.2024 00:00;140592;116642;23950;7.1
20068709;288156;2;16.07.2024 00:00;42011;27000;15011;1.7
20068561;282129;2;16.07.2024 00:00;29907;12056;17851;0.8
20068707;288088;2;16.07.2024 00:00;32002;29162;2840;1.8
20068706;288076;2;16.07.2024 00:00;23000;27000;-4000;1.6
20068438;288049;2;16.07.2024 00:00;51186;37946;13240;2.4
20068440;282227;2;16.07.2024 00:00;12502;12056;446;0.8
20067977;266437;2;17.07.2024 00:00;605746;547202;58544;34.1
20067978;266437;2;19.07.2024 00:00;573431;547202;26229;33.1
20068446;282978;2;20.07.2024 00:00;101646;91842;9804;5.6
20068434;282309;2;21.07.2024 00:00;97455;52192;45263;3.8
20068441;;2;21.07.2024 00:00;0;0;0;0.0
20068445;282308;2;21.07.2024 00:00;168293;156578;11715;10.9
20068501;281017;2;22.07.2024 00:00;199538;178947;20591;11.6
20068431;;2;23.07.2024 00:00;0;0;0;0.0
20068565;279589;2;23.07.2024 00:00;125741;102170;23571;6.4
20068564;273109;2;23.07.2024 00:00;44263;24771;19492;1.7
20068566;282713;2;24.07.2024 00:00;151912;123842;28070;7.7
20068700;277259;2;24.07.2024 00:00;327929;306506;21423;19.3
20068567;284339;2;24.07.2024 00:00;22502;21674;828;1.4
20068697;266275;2;25.07.2024 00:00;195083;167184;27899;10.4
20068701;279757;2;26.07.2024 00:00;146891;123840;23051;7.5
20068699;251807;2;26.07.2024 00:00;114034;102945;11089;6.8
20068698;234028;2;27.07.2024 00:00;198390;182666;15724;11.0
20069214;278280;2;27.07.2024 00:00;108752;102170;6582;6.2
20069215;279755;2;28.07.2024 00:00;212961;204336;8625;12.8
20069211;238904;2;28.07.2024 00:00;48166;40251;7915;2.6
20069549;287058;2;12.08.2024 00:00;618140;532952;85188;34.1
20069550;287793;2;14.08.2024 00:00;228754;213180;15574;12.8
20069680;287793;2;14.08.2024 00:00;112909;106592;6317;6.7
20069679;286375;2;14.08.2024 00:00;439748;426362;13386;25.8
20070030;;2;16.08.2024 00:00;0;0;0;0.0
20069689;281014;2;16.08.2024 00:00;86617;59650;26967;4.1
20069690;281021;2;17.08.2024 00:00;51852;50330;1522;3.4
20069691;285764;2;17.08.2024 00:00;60851;55923;4928;3.7
20069692;288429;2;17.08.2024 00:00;92382;89475;2907;6.1
20069685;263462;2;18.08.2024 00:00;89845;73630;16215;5.3
20070010;;2;18.08.2024 00:00;0;0;0;0.0
20069686;275984;2;18.08.2024 00:00;57875;33552;24323;2.6
20069694;287991;2;18.08.2024 00:00;433333;396290;37043;26.1
20069687;275987;2;18.08.2024 00:00;53761;44736;9025;2.7
20069683;241154;2;20.08.2024 00:00;87731;61920;25811;3.7
20069695;277258;2;20.08.2024 00:00;53333;40251;13082;2.5
20069684;257462;2;20.08.2024 00:00;24241;34832;-10591;1.4
20069693;279949;2;21.08.2024 00:00;61612;58826;2786;3.6
20069681;236237;2;21.08.2024 00:00;118614;102168;16446;6.2
20069682;237427;2;21.08.2024 00:00;44699;43346;1353;2.6
20069925;277260;2;21.08.2024 00:00;66371;61922;4449;3.8
20069688;278355;2;22.08.2024 00:00;283821;272450;11371;16.4
20069923;257342;2;22.08.2024 00:00;118173;102170;16003;6.2
20069930;278577;2;23.08.2024 00:00;207641;173378;34263;10.3
20069924;259676;2;23.08.2024 00:00;326302;297218;29084;18.0
20069929;266335;2;24.08.2024 00:00;183731;164088;19643;9.8
20069931;280357;2;25.08.2024 00:00;125452;123842;1610;7.7
20069978;280190;2;25.08.2024 00:00;75662;71211;4451;4.3
20070056;261524;2;25.08.2024 00:00;112997;102168;10829;6.1
20070055;259089;2;26.08.2024 00:00;65985;61922;4063;3.7
20070053;234093;2;26.08.2024 00:00;48002;40250;7752;2.5
20070063;279434;2;26.08.2024 00:00;106881;102170;4711;6.1
20070057;268032;2;26.08.2024 00:00;54198;40225;13973;2.5
20070054;253693;2;27.08.2024 00:00;49041;32258;16783;2.0
20070124;274474;2;27.08.2024 00:00;36765;32258;4507;2.0
20070123;253693;2;27.08.2024 00:00;37002;32258;4744;2.0
20070128;287623;2;27.08.2024 00:00;34937;27866;7071;1.7
20070125;276788;2;27.08.2024 00:00;35188;32258;2930;2.0
20070158;;2;28.08.2024 00:00;0;0;0;0.0
20070126;286375;2;28.08.2024 00:00;208352;177653;30699;10.9
20070204;286375;2;28.08.2024 00:00;284451;248710;35741;15.2
20070205;286375;2;29.08.2024 00:00;447604;426362;21242;26.3
20070206;286375;2;31.08.2024 00:00;267508;248712;18796;15.8
20070590;286375;2;31.08.2024 00:00;229565;213180;16385;13.0
20070262;288642;2;01.09.2024 00:00;115870;106592;9278;6.5
20070260;286662;2;01.09.2024 00:00;114086;106594;7492;6.4
20070261;288602;2;02.09.2024 00:00;136791;129203;7588;7.8
20070285;287337;2;02.09.2024 00:00;112827;103362;9465;6.4
20070286;;2;02.09.2024 00:00;0;0;0;0.0
20070464;287907;2;03.09.2024 00:00;47869;25602;22267;1.8
20070463;287373;2;03.09.2024 00:00;26258;25602;656;2.1
20070462;270683;2;03.09.2024 00:00;181359;154882;26477;9.6
20070476;236435;2;04.09.2024 00:00;50834;43882;6952;2.7
20070465;234742;2;04.09.2024 00:00;202765;175522;27243;10.9
20070481;275872;2;04.09.2024 00:00;41238;38397;2841;2.3
20070466;241454;2;05.09.2024 00:00;170658;144807;25851;9.8
20070477;239882;2;05.09.2024 00:00;34373;32912;1461;2.1
20070445;270733;2;05.09.2024 00:00;96562;91202;5360;5.7
20070441;282233;2;06.09.2024 00:00;17152;13779;3373;0.9
20070440;282232;2;06.09.2024 00:00;15982;13778;2204;0.9
20070442;282235;2;06.09.2024 00:00;16398;13778;2620;0.9
20070447;282229;2;06.09.2024 00:00;17992;13778;4214;0.9
20070438;282131;2;06.09.2024 00:00;60441;41329;19112;2.5
20070446;282227;2;06.09.2024 00:00;6259;13776;-7517;0.8
20070439;282228;2;06.09.2024 00:00;50296;41328;8968;2.6
20070443;288519;2;07.09.2024 00:00;438239;417386;20853;25.9
20070834;286860;2;08.09.2024 00:00;123886;109082;14804;6.6
20070832;286257;2;08.09.2024 00:00;87622;74520;13102;4.5
20070833;286712;2;09.09.2024 00:00;26073;31860;-5787;2.0
20070480;271400;2;09.09.2024 00:00;83563;66530;17033;4.1
20070479;271400;2;09.09.2024 00:00;78392;70562;7830;4.1
20070437;266437;2;09.09.2024 00:00;584712;547202;37510;33.6
20070478;271399;2;09.09.2024 00:00;74002;70562;3440;4.1
20070655;266437;2;11.09.2024 00:00;587502;547202;40300;33.1
20070656;;2;13.09.2024 00:00;0;0;0;0.0
20070737;272734;2;13.09.2024 00:00;63707;46602;17105;3.1
20070739;281146;2;14.09.2024 00:00;187463;171490;15973;11.4
20070738;278030;2;14.09.2024 00:00;142619;104721;37898;6.5
20070657;;2;14.09.2024 00:00;0;0;0;0.0
20070735;268975;2;15.09.2024 00:00;275686;241346;34340;14.2
20070740;284145;2;15.09.2024 00:00;28159;28560;-401;1.8
20070753;268975;2;16.09.2024 00:00;274172;241344;32828;14.8
20070836;279169;2;17.09.2024 00:00;254115;241348;12767;15.0
20070900;288653;2;17.09.2024 00:00;23633;11313;12320;0.7
20070898;286847;2;18.09.2024 00:00;91908;80450;11458;5.3
20070899;286849;2;18.09.2024 00:00;11452;10896;556;0.6
20070894;276788;2;18.09.2024 00:00;82667;64514;18153;4.1
20070895;277198;2;18.09.2024 00:00;13300;10058;3242;0.6
20070982;264643;2;18.09.2024 00:00;320957;276484;44473;17.4
20070984;283868;2;18.09.2024 00:00;34908;32258;2650;2.0
20071153;277951;2;20.09.2024 00:00;80268;69122;11146;4.5
20071154;285375;2;20.09.2024 00:00;304975;276482;28493;16.9
20070983;280080;2;21.09.2024 00:00;31021;27362;3659;1.7
20070988;285579;2;21.09.2024 00:00;254669;220886;33783;13.3
20071050;237781;2;22.09.2024 00:00;65435;43344;22091;2.7
20071120;287991;2;22.09.2024 00:00;519743;495362;24381;29.6
20071155;287991;2;24.09.2024 00:00;250035;222912;27123;13.4
20071119;256199;2;25.09.2024 00:00;94759;92884;1875;5.5
20071117;239383;2;25.09.2024 00:00;44811;30962;13849;1.8
20071280;254050;2;25.09.2024 00:00;49275;40248;9027;2.0
20071118;242275;2;25.09.2024 00:00;55002;49538;5464;2.9
20071281;288678;2;26.09.2024 00:00;114002;99074;14928;6.2
20071301;233776;2;26.09.2024 00:00;107290;102170;5120;6.3
20071305;279757;2;26.09.2024 00:00;134608;123840;10768;7.3
20071300;;2;27.09.2024 00:00;0;0;0;0.0
20071302;286375;2;27.09.2024 00:00;132471;106592;25879;6.7
20071303;287793;2;27.09.2024 00:00;120180;106592;13588;6.5
20071304;288979;2;28.09.2024 00:00;506691;461892;44799;28.5
20071477;288979;2;29.09.2024 00:00;111056;106592;4464;6.6
20071351;286680;2;29.09.2024 00:00;112049;106592;5457;6.7
20071408;286003;2;30.09.2024 00:00;402013;355300;46713;22.1
20071476;286003;2;01.10.2024 00:00;224850;213182;11668;13.0
20071747;286003;2;02.10.2024 00:00;114602;106592;8010;6.6
20071409;288887;2;03.10.2024 00:00;158651;142122;16529;8.8
20071410;;2;03.10.2024 00:00;0;0;0;0.0
20071478;274088;2;03.10.2024 00:00;363649;302102;61547;18.7
20071542;284002;2;05.10.2024 00:00;38671;24769;13902;1.5
20071537;236237;2;05.10.2024 00:00;116332;102170;14162;6.1
20071541;281900;2;06.10.2024 00:00;25639;24770;869;1.5
20071536;235286;2;06.10.2024 00:00;87344;71984;15360;4.3
20071540;279589;2;06.10.2024 00:00;114397;102169;12228;6.1
20071538;237262;2;06.10.2024 00:00;35002;30962;4040;2.2
20071539;277255;2;06.10.2024 00:00;105302;102170;3132;6.3
20071558;234028;2;07.10.2024 00:00;113901;102169;11732;6.4
20071569;278577;2;07.10.2024 00:00;203503;173378;30125;10.2
20071632;277261;2;08.10.2024 00:00;190537;173376;17161;10.6
20071631;259676;2;08.10.2024 00:00;748026;718274;29752;42.9
20071786;279590;2;10.10.2024 00:00;152322;133130;19192;8.2
20071788;284243;2;11.10.2024 00:00;30611;24770;5841;1.4
20071789;285005;2;11.10.2024 00:00;35636;34058;1578;2.1
20071785;277259;2;11.10.2024 00:00;228750;204336;24414;12.7
20071782;257340;2;12.10.2024 00:00;107732;102171;5561;6.1
20071787;282713;2;12.10.2024 00:00;141910;120744;21166;7.3
20071780;237611;2;13.10.2024 00:00;71702;61148;10554;3.7
20071779;234830;2;13.10.2024 00:00;114271;102168;12103;6.1
20071790;288816;2;13.10.2024 00:00;38652;37154;1498;2.2
20071778;234706;2;14.10.2024 00:00;434028;408676;25352;24.7
20071781;250493;2;15.10.2024 00:00;212048;204338;7710;12.3
20071783;288633;2;15.10.2024 00:00;82251;64516;17735;3.9
20072168;282346;2;16.10.2024 00:00;53159;40226;12933;2.4
20072167;280363;2;16.10.2024 00:00;34899;32258;2641;2.0
20072173;288921;2;16.10.2024 00:00;19894;13982;5912;0.8
20072174;288922;2;16.10.2024 00:00;20073;13983;6090;0.9
20072165;;2;17.10.2024 00:00;0;0;0;0.0
20072204;275509;2;17.10.2024 00:00;2;2;0;2.1
20072166;227780;2;17.10.2024 00:00;57297;22370;34927;1.7
20072171;288767;2;17.10.2024 00:00;165633;130480;35153;8.4
20071784;;2;18.10.2024 00:00;0;0;0;0.0
20072172;288768;2;18.10.2024 00:00;35325;44736;-9411;2.9
20072175;289080;2;18.10.2024 00:00;131534;108642;22892;6.8
20072169;287552;2;19.10.2024 00:00;126234;108640;17594;6.8
20072170;288602;2;19.10.2024 00:00;610879;570362;40517;35.3
20072233;287058;2;21.10.2024 00:00;294542;248714;45828;16.1
20072262;286662;2;22.10.2024 00:00;189098;177650;11448;10.8
20072265;249831;2;22.10.2024 00:00;224856;122294;102562;9.8
20072264;;2;22.10.2024 00:00;0;0;0;0.0
20072370;285375;2;24.10.2024 00:00;216458;184322;32136;11.6
20072371;286894;2;25.10.2024 00:00;107435;92163;15272;5.6
20072372;289049;2;26.10.2024 00:00;406665;368642;38023;22.0
20072369;281524;2;27.10.2024 00:00;282426;250497;31929;15.6
20072443;268975;2;27.10.2024 00:00;273428;241346;32082;14.8
20072444;268975;2;28.10.2024 00:00;260372;241346;19026;14.8
20072518;273854;2;29.10.2024 00:00;53579;40227;13352;2.5
20072517;266305;2;29.10.2024 00:00;39118;40224;-1106;2.3
20072520;288016;2;30.10.2024 00:00;83879;69050;14829;5.9
20072519;280080;2;30.10.2024 00:00;37807;25923;11884;1.6
20072513;234094;2;30.10.2024 00:00;49417;37154;12263;2.2
20072515;234705;2;31.10.2024 00:00;56998;46442;10556;2.9
20072516;236666;2;31.10.2024 00:00;48002;43346;4656;2.6
20072514;234704;2;31.10.2024 00:00;117049;102168;14881;6.2
20072587;241513;2;31.10.2024 00:00;153560;139322;14238;8.6
20072586;234706;2;01.11.2024 00:00;433103;408675;24428;24.8
20072662;244550;2;02.11.2024 00:00;58111;61920;-3809;3.7
20072665;277261;2;02.11.2024 00:00;188756;173376;15380;10.3
20072663;259676;2;03.11.2024 00:00;327313;321986;5327;19.2
20072664;277258;2;03.11.2024 00:00;51722;43344;8378;2.7
20072701;280357;2;04.11.2024 00:00;459204;421060;38144;26.2
20072848;289114;2;05.11.2024 00:00;40753;34686;6067;3.3
20072805;276788;2;05.11.2024 00:00;43980;32257;11723;2.3
20072802;266480;2;06.11.2024 00:00;65140;64512;628;4.2
20072811;280223;2;06.11.2024 00:00;15000;10056;4944;0.8
20072809;277198;2;06.11.2024 00:00;13321;9637;3684;0.6
20072804;267344;2;06.11.2024 00:00;40551;32256;8295;2.2
20072813;286847;2;06.11.2024 00:00;68928;60336;8592;3.8
20072931;260373;2;06.11.2024 00:00;23098;15084;8014;1.0
20072930;241392;2;07.11.2024 00:00;30689;34560;-3871;2.2
20072932;269893;2;07.11.2024 00:00;104462;80450;24012;5.3
20072933;279169;2;07.11.2024 00:00;252315;241346;10969;14.8
20072934;284143;2;08.11.2024 00:00;70179;52362;17817;3.6
20072939;;2;08.11.2024 00:00;0;0;0;0.0
20072940;288642;2;08.11.2024 00:00;170721;153752;16969;8.9
20073224;286680;2;09.11.2024 00:00;193500;177652;15848;11.2
20073094;;2;10.11.2024 00:00;0;0;0;0.0
20073234;286780;2;10.11.2024 00:00;63580;27962;35618;1.6
20073097;286931;2;10.11.2024 00:00;15779;15779;0;7.5
20073095;272736;2;11.11.2024 00:00;141540;111842;29698;6.7
20073223;270855;2;11.11.2024 00:00;105966;80154;25812;4.7
20073225;289178;2;11.11.2024 00:00;11886;11186;700;0.7
20073222;270855;2;12.11.2024 00:00;170258;169628;630;10.1
20073228;;2;12.11.2024 00:00;0;0;0;0.0
20073279;239082;2;12.11.2024 00:00;115657;102171;13486;6.0
20073276;266275;2;12.11.2024 00:00;201771;173378;28393;10.4
20073666;275509;2;13.11.2024 00:00;0;0;0;2.9
20073277;279755;2;13.11.2024 00:00;224343;204338;20005;12.3
20073278;279755;2;14.11.2024 00:00;337991;303412;34579;18.9
20073275;252247;2;15.11.2024 00:00;112600;102170;10430;6.0
20073342;277259;2;16.11.2024 00:00;419448;408675;10773;24.5
20073343;287991;2;17.11.2024 00:00;266870;243037;23833;14.7
20042641;269588;3;10.01.2023 00:00;227212;188370;38842;25.2
20042719;259865;3;11.01.2023 00:00;45393;25920;19473;4.6
20042717;281929;3;11.01.2023 00:00;26423;21418;5005;3.2
20041893;;3;12.01.2023 00:00;0;0;0;0.0
20042715;276758;3;12.01.2023 00:00;319164;259840;59324;34.8
20042224;;3;14.01.2023 00:00;0;0;0;0.0
20042716;281017;3;16.01.2023 00:00;40259;33552;6707;4.1
20042723;277189;3;16.01.2023 00:00;65906;52192;13714;6.4
20042721;272433;3;16.01.2023 00:00;67805;62444;5361;7.7
20042718;282308;3;17.01.2023 00:00;354153;331794;22359;37.6
20042724;282309;3;19.01.2023 00:00;73750;70832;2918;8.4
20042720;270855;3;19.01.2023 00:00;72041;68036;4005;8.1
20042722;276609;3;19.01.2023 00:00;55050;27960;27090;3.5
20043266;265384;3;20.01.2023 00:00;37272;31688;5584;3.9
20043280;;3;20.01.2023 00:00;0;0;0;0.0
20043268;281497;3;20.01.2023 00:00;34710;33552;1158;4.1
20043267;280398;3;20.01.2023 00:00;49342;43806;5536;5.0
20043282;;3;30.01.2023 00:00;0;0;0;0.0
20043925;268831;3;30.01.2023 00:00;104225;86968;17257;12.9
20043928;278996;3;30.01.2023 00:00;40662;30978;9684;4.0
20043929;280584;3;31.01.2023 00:00;25110;18304;6806;2.7
20043939;274301;3;31.01.2023 00:00;21482;19008;2474;2.5
20043941;257250;3;31.01.2023 00:00;36715;27000;9715;4.3
20043940;277007;3;01.02.2023 00:00;344427;322922;21505;42.7
20044458;275252;3;03.02.2023 00:00;57950;53820;4130;7.1
20044460;275252;3;03.02.2023 00:00;53300;53820;-520;7.1
20044755;283093;3;03.02.2023 00:00;61200;37664;23536;5.7
20044756;283095;3;09.02.2023 00:00;58349;53152;5197;8.0
20043894;;3;10.02.2023 00:00;0;0;0;0.0
20044461;211506;3;10.02.2023 00:00;44552;25502;19050;3.7
20044752;275233;3;10.02.2023 00:00;16922;6650;10272;1.6
20043478;;3;10.02.2023 00:00;0;0;0;0.0
20044753;276758;3;11.02.2023 00:00;75180;58242;16938;7.5
20044894;264369;3;11.02.2023 00:00;47943;26185;21758;3.9
20044152;;3;11.02.2023 00:00;0;0;0;0.0
20044990;265102;3;12.02.2023 00:00;37928;26180;11748;3.9
20044986;230400;3;12.02.2023 00:00;122150;102340;19810;13.1
20044988;262255;3;13.02.2023 00:00;32269;26180;6089;3.6
20044895;269343;3;13.02.2023 00:00;32280;26180;6100;3.1
20044992;271999;3;13.02.2023 00:00;28130;26180;1950;3.4
20044993;276582;3;14.02.2023 00:00;30800;26180;4620;3.7
20044989;265002;3;14.02.2023 00:00;64044;57120;6924;7.0
20044991;267090;3;14.02.2023 00:00;57726;42874;14852;5.0
20045135;;3;15.02.2023 00:00;0;0;0;0.0
20044985;227780;3;15.02.2023 00:00;47232;41940;5292;5.3
20044987;262248;3;15.02.2023 00:00;33710;27028;6682;3.1
20044874;282993;3;15.02.2023 00:00;77900;67104;10796;8.0
20044873;282987;3;16.02.2023 00:00;98560;90404;8156;10.8
20044890;270036;3;16.02.2023 00:00;64940;59648;5292;6.7
20045615;272734;3;17.02.2023 00:00;18910;16776;2134;1.8
20045614;272730;3;17.02.2023 00:00;28739;29824;-1085;3.7
20046261;278663;3;13.03.2023 00:00;292529;256700;35829;31.4
20046260;277787;3;15.03.2023 00:00;97681;75600;22081;9.6
20046258;276350;3;16.03.2023 00:00;63321;51300;12021;6.8
20046357;;3;16.03.2023 00:00;0;0;0;0.0
20046360;273089;3;16.03.2023 00:00;53110;36346;16764;5.8
20046361;273090;3;17.03.2023 00:00;30892;25960;4932;3.3
20046363;278612;3;20.03.2023 00:00;22077;17654;4423;2.4
20046364;278996;3;20.03.2023 00:00;79480;61248;18232;8.3
20046365;278997;3;21.03.2023 00:00;63779;61251;2528;9.4
20046362;278352;3;21.03.2023 00:00;97112;84196;12916;11.5
20048106;278352;3;11.04.2023 00:00;72742;71297;1445;9.0
20048105;262903;3;11.04.2023 00:00;45638;24445;21193;3.9
20047712;;3;12.04.2023 00:00;0;0;0;0.0
20047544;;3;12.04.2023 00:00;0;0;0;0.0
20048111;270855;3;12.04.2023 00:00;64232;47533;16699;5.7
20048107;283619;3;12.04.2023 00:00;1056;1056;0;0.0
20048110;241023;3;13.04.2023 00:00;41782;27960;13822;3.5
20047713;;3;13.04.2023 00:00;0;0;0;0.0
20048182;275987;3;13.04.2023 00:00;61666;44739;16927;6.2
20048183;280080;3;14.04.2023 00:00;60466;46080;14386;5.6
20048184;282603;3;14.04.2023 00:00;64220;48672;15548;6.5
20048185;283541;3;14.04.2023 00:00;301809;277056;24753;33.0
20048400;283542;3;16.04.2023 00:00;241974;220896;21078;26.2
20048729;;3;24.04.2023 00:00;0;0;0;0.0
20048902;283830;3;25.04.2023 00:00;47140;26240;20900;3.5
20048757;281969;3;25.04.2023 00:00;67470;43521;23949;5.3
20048756;277787;3;26.04.2023 00:00;28902;10802;18100;1.4
20048995;274301;3;26.04.2023 00:00;62400;28864;33536;4.2
20048730;;3;26.04.2023 00:00;0;0;0;0.0
20048994;274300;3;26.04.2023 00:00;149400;137280;12120;18.4
20048997;278993;3;27.04.2023 00:00;34790;27808;6982;3.7
20048998;283058;3;28.04.2023 00:00;37291;29205;8086;3.6
20048966;;3;28.04.2023 00:00;0;0;0;0.0
20049075;283869;3;28.04.2023 00:00;29119;23040;6079;2.9
20049074;282308;3;28.04.2023 00:00;91434;78288;13146;9.6
20049069;;3;28.04.2023 00:00;0;0;0;0.0
20049071;269066;3;29.04.2023 00:00;88670;78288;10382;9.1
20049073;272736;3;29.04.2023 00:00;148837;130480;18357;15.2
20049072;271791;3;30.04.2023 00:00;55900;53124;2776;6.5
20049463;270036;3;16.05.2023 00:00;14500;11184;3316;1.7
20049070;265531;3;16.05.2023 00:00;62735;54056;8679;6.4
20049512;272433;3;16.05.2023 00:00;143605;134212;9393;16.0
20049775;;3;17.05.2023 00:00;0;0;0;0.0
20049694;262248;3;17.05.2023 00:00;33182;27962;5220;3.1
20049778;265002;3;22.05.2023 00:00;30420;26180;4240;3.2
20049776;227144;3;22.05.2023 00:00;32245;26180;6065;3.3
20050107;271999;3;22.05.2023 00:00;34930;26180;8750;3.3
20049777;230400;3;22.05.2023 00:00;46267;40462;5805;4.8
20050435;282603;3;23.05.2023 00:00;85615;56581;29034;7.5
20050106;;3;23.05.2023 00:00;0;0;0;0.0
20050420;211506;3;24.05.2023 00:00;113918;79050;34868;12.0
20050421;278612;3;24.05.2023 00:00;32700;27160;5540;3.8
20050675;;3;25.05.2023 00:00;0;0;0;0.0
20050678;278994;3;25.05.2023 00:00;36799;29568;7231;4.2
20050677;278993;3;25.05.2023 00:00;33860;31328;2532;4.5
20050813;274301;3;25.05.2023 00:00;34226;26752;7474;3.9
20050680;283408;3;26.05.2023 00:00;31220;29920;1300;4.1
20050676;273755;3;26.05.2023 00:00;35300;27160;8140;4.5
20051171;;3;16.06.2023 00:00;0;0;0;0.0
20051446;262248;3;16.06.2023 00:00;53863;27960;25903;3.9
20051181;282993;3;16.06.2023 00:00;62034;51262;10772;6.3
20051179;282309;3;17.06.2023 00:00;67008;55920;11088;7.3
20051180;282987;3;19.06.2023 00:00;67450;55920;11530;6.9
20051182;284087;3;19.06.2023 00:00;113937;102524;11413;11.9
20051183;270036;3;20.06.2023 00:00;129585;115568;14017;13.4
20051184;271396;3;20.06.2023 00:00;146948;143528;3420;16.4
20051594;284364;3;21.06.2023 00:00;20786;13049;7737;1.4
20051447;275875;3;21.06.2023 00:00;105890;104384;1506;12.3
20051402;;3;22.06.2023 00:00;0;0;0;0.0
20051789;278996;3;22.06.2023 00:00;32284;22880;9404;3.1
20051787;278995;3;22.06.2023 00:00;33432;30272;3160;4.2
20051788;278995;3;22.06.2023 00:00;32285;27456;4829;3.7
20051790;278997;3;23.06.2023 00:00;25220;24640;580;3.1
20051786;274249;3;23.06.2023 00:00;188058;168258;19800;22.4
20051791;280584;3;24.06.2023 00:00;29002;27810;1192;4.5
20051792;284263;3;24.06.2023 00:00;20150;9280;10870;0.7
20051979;265724;3;25.06.2023 00:00;310600;266571;44029;34.6
20051403;;3;25.06.2023 00:00;0;0;0;0.0
20051898;284343;3;26.06.2023 00:00;60205;35845;24360;4.3
20052299;284343;3;27.06.2023 00:00;46022;40960;5062;5.4
20051897;263539;3;27.06.2023 00:00;62732;46720;16012;6.0
20051977;236681;3;28.06.2023 00:00;149566;117760;31806;15.1
20051976;218903;3;29.06.2023 00:00;210518;174082;36436;22.7
20052467;;3;06.07.2023 00:00;0;0;0;0.0
20052768;283217;3;06.07.2023 00:00;34879;26400;8479;3.6
20052473;284204;3;07.07.2023 00:00;34045;27458;6587;4.5
20052474;284205;3;07.07.2023 00:00;33162;27456;5706;4.3
20052472;283408;3;24.07.2023 00:00;46633;27456;19177;4.0
20053504;274300;3;24.07.2023 00:00;32035;27456;4579;3.9
20053154;274301;3;24.07.2023 00:00;14600;14080;520;2.1
20052470;274302;3;24.07.2023 00:00;28100;27456;644;3.7
20053072;278994;3;25.07.2023 00:00;35050;32032;3018;4.1
20053074;278997;3;25.07.2023 00:00;33550;30624;2926;4.0
20053155;278996;3;25.07.2023 00:00;33505;31680;1825;4.3
20053156;;3;25.07.2023 00:00;0;0;0;0.0
20053076;284351;3;25.07.2023 00:00;77442;69258;8184;9.6
20053108;;3;26.07.2023 00:00;0;0;0;0.0
20053079;280080;3;26.07.2023 00:00;73755;50400;23355;6.1
20053078;275172;3;26.07.2023 00:00;168618;126588;42030;16.3
20053344;277787;3;28.07.2023 00:00;84003;62100;21903;8.6
20053221;;3;28.07.2023 00:00;0;0;0;0.0
20053343;276350;3;28.07.2023 00:00;33447;22140;11307;2.8
20053345;278143;3;14.08.2023 00:00;47855;30782;17073;4.4
20053424;278142;3;14.08.2023 00:00;52625;42120;10505;5.6
20053425;278144;3;14.08.2023 00:00;70740;60480;10260;7.5
20054098;273602;3;15.08.2023 00:00;28454;20250;8204;3.2
20054469;274301;3;15.08.2023 00:00;83905;61971;21934;9.2
20054350;;3;15.08.2023 00:00;0;0;0;0.0
20054468;274249;3;17.08.2023 00:00;36177;28160;8017;3.8
20054470;283217;3;18.08.2023 00:00;38723;27456;11267;4.3
20054494;284206;3;18.08.2023 00:00;33200;27456;5744;4.0
20054493;280659;3;18.08.2023 00:00;120620;101171;19449;14.1
20054528;273755;3;21.08.2023 00:00;45514;27163;18351;3.6
20054466;;3;21.08.2023 00:00;0;0;0;0.0
20054529;230400;3;22.08.2023 00:00;258839;161842;96997;22.1
20054820;230400;3;24.08.2023 00:00;94931;73780;21151;10.5
20054823;265102;3;25.08.2023 00:00;38300;26180;12120;3.3
20054822;263803;3;25.08.2023 00:00;32750;26180;6570;3.5
20054821;262255;3;28.08.2023 00:00;31142;26182;4960;3.0
20054819;225132;3;28.08.2023 00:00;29970;26180;3790;3.3
20054824;265672;3;28.08.2023 00:00;29702;26182;3520;3.0
20054826;271999;3;28.08.2023 00:00;31124;26180;4944;3.5
20054825;269343;3;28.08.2023 00:00;29623;26182;3441;3.2
20054829;280080;3;29.08.2023 00:00;61100;45720;15380;5.3
20054827;271999;3;29.08.2023 00:00;30735;26180;4555;3.1
20054828;280080;3;29.08.2023 00:00;47221;46082;1139;5.5
20054533;284544;3;29.08.2023 00:00;137448;116039;21409;13.8
20054560;;3;30.08.2023 00:00;0;0;0;0.0
20054745;272734;3;30.08.2023 00:00;75625;54990;20635;7.0
20054747;282309;3;31.08.2023 00:00;61500;52192;9308;6.3
20054748;284087;3;31.08.2023 00:00;62948;51261;11687;6.3
20054746;281146;3;01.09.2023 00:00;319300;301968;17332;34.2
20054813;282000;3;03.09.2023 00:00;54186;52192;1994;6.3
20055176;270855;3;03.09.2023 00:00;71716;62446;9270;7.4
20054965;281014;3;11.09.2023 00:00;160352;139800;20552;16.5
20053423;;3;12.09.2023 00:00;0;0;0;0.0
20055437;284204;3;12.09.2023 00:00;38499;19361;19138;2.9
20055435;278997;3;12.09.2023 00:00;38750;29217;9533;4.5
20055438;284206;3;12.09.2023 00:00;26120;22176;3944;2.6
20055436;283408;3;13.09.2023 00:00;26420;28160;-1740;4.0
20055439;284351;3;13.09.2023 00:00;47359;27160;20199;4.2
20055608;;3;13.09.2023 00:00;0;0;0;0.0
20055510;262903;3;13.09.2023 00:00;41909;31235;10674;4.8
20055508;200418;3;14.09.2023 00:00;43500;25500;18000;4.2
20055603;211506;3;14.09.2023 00:00;84063;74800;9263;10.1
20055604;211506;3;15.09.2023 00:00;35729;32300;3429;4.6
20055602;;3;15.09.2023 00:00;0;0;0;0.0
20055783;285077;3;15.09.2023 00:00;5939;3729;2210;9.0
20055784;285137;3;16.09.2023 00:00;10175;6121;4054;0.8
20055782;285039;3;16.09.2023 00:00;1864;1864;0;5.5
20055607;283542;3;16.09.2023 00:00;54225;44176;10049;5.6
20055606;283541;3;16.09.2023 00:00;96600;87984;8616;10.5
20055845;263462;3;17.09.2023 00:00;102746;82016;20730;10.2
20055979;251975;3;18.09.2023 00:00;44100;37280;6820;4.6
20055618;;3;18.09.2023 00:00;0;0;0;0.0
20055982;281017;3;18.09.2023 00:00;124261;116500;7761;13.3
20055848;282308;3;21.09.2023 00:00;328119;301970;26149;36.3
20055847;281146;3;23.09.2023 00:00;150305;141664;8641;16.8
20055849;282309;3;23.09.2023 00:00;67595;63376;4219;7.3
20056144;285197;3;24.09.2023 00:00;59700;55920;3780;6.5
20055609;;3;24.09.2023 00:00;0;0;0;0.0
20056335;278663;3;24.09.2023 00:00;26834;19746;7088;2.5
20056336;278663;3;24.09.2023 00:00;141925;121767;20158;16.7
20056438;278663;3;25.09.2023 00:00;163026;144804;18222;18.4
20056518;273755;3;26.09.2023 00:00;37460;27839;9621;4.1
20056334;;3;26.09.2023 00:00;0;0;0;0.0
20056337;284263;3;26.09.2023 00:00;7542;7542;0;4.1
20056268;284803;3;27.09.2023 00:00;162699;148898;13801;20.9
20056267;284207;3;29.09.2023 00:00;35664;27810;7854;4.2
20042510;238061;4;03.01.2023 00:00;66275;50336;15939;11.8
20042749;281114;4;03.01.2023 00:00;15709;10120;5589;2.7
20042512;276094;4;04.01.2023 00:00;120721;107016;13705;21.9
20042511;276092;4;05.01.2023 00:00;50727;50962;-235;10.1
20042754;276093;4;05.01.2023 00:00;62616;59152;3464;11.5
20042883;271211;4;06.01.2023 00:00;3450;1760;1690;0.4
20042884;282467;4;06.01.2023 00:00;13106;13106;0;3.6
20042481;;4;07.01.2023 00:00;0;0;0;0.0
20043179;247217;4;07.01.2023 00:00;64547;30020;34527;9.8
20043178;238974;4;10.01.2023 00:00;26773;15010;11763;5.8
20043183;281797;4;19.01.2023 00:00;768;768;0;0.0
20043182;281766;4;23.01.2023 00:00;13000;10368;2632;2.8
20043181;281765;4;23.01.2023 00:00;14800;11136;3664;2.4
20043624;274294;4;23.01.2023 00:00;62020;55296;6724;9.9
20043180;274305;4;24.01.2023 00:00;38300;30720;7580;5.1
20044020;275888;4;24.01.2023 00:00;44230;35328;8902;5.8
20043625;274306;4;24.01.2023 00:00;11400;10560;840;2.1
20044097;275509;4;24.01.2023 00:00;5750;1;5749;0.0
20043544;278286;4;25.01.2023 00:00;166579;150402;16177;24.9
20043627;282396;4;26.01.2023 00:00;22950;15744;7206;3.3
20043914;282899;4;26.01.2023 00:00;5054;2045;3009;0.3
20043670;268867;4;26.01.2023 00:00;49062;40180;8882;7.5
20042482;;4;26.01.2023 00:00;0;0;0;0.0
20043671;273735;4;27.01.2023 00:00;32683;29120;3563;5.5
20043672;281746;4;27.01.2023 00:00;57789;53760;4029;10.2
20043812;277331;4;28.01.2023 00:00;16000;10368;5632;2.4
20043813;277332;4;28.01.2023 00:00;12700;11088;1612;2.2
20043815;282395;4;28.01.2023 00:00;25220;18480;6740;3.7
20043814;282157;4;29.01.2023 00:00;40204;28565;11639;5.7
20043886;281570;4;29.01.2023 00:00;69382;64822;4560;12.3
20043911;282869;4;03.02.2023 00:00;33532;31362;2170;6.2
20043910;282869;4;06.02.2023 00:00;43390;32900;10490;5.3
20043173;;4;06.02.2023 00:00;0;0;0;0.0
20044276;269178;4;06.02.2023 00:00;16200;10032;6168;2.3
20044277;282394;4;06.02.2023 00:00;20916;15841;5075;3.8
20044278;282898;4;07.02.2023 00:00;1650;1001;649;1.6
20044411;277470;4;07.02.2023 00:00;29314;25025;4289;5.9
20044415;282834;4;07.02.2023 00:00;12884;10101;2783;2.3
20044462;281114;4;08.02.2023 00:00;31210;26224;4986;6.1
20044414;282828;4;08.02.2023 00:00;11637;10010;1627;2.8
20044463;282683;4;08.02.2023 00:00;14014;10192;3822;2.3
20044464;282684;4;08.02.2023 00:00;13855;10192;3663;2.5
20044466;282682;4;09.02.2023 00:00;15468;10011;5457;2.3
20045125;277799;4;17.02.2023 00:00;37681;29376;8305;5.7
20044683;;4;18.02.2023 00:00;0;0;0;0.0
20045126;278032;4;18.02.2023 00:00;11902;10370;1532;2.0
20045714;281723;4;20.02.2023 00:00;28443;21889;6554;4.0
20045169;;4;20.02.2023 00:00;0;0;0;0.0
20045305;281563;4;20.02.2023 00:00;87300;76153;11147;11.8
20045440;281410;4;21.02.2023 00:00;41895;39721;2174;6.2
20045446;262838;4;21.02.2023 00:00;33655;25300;8355;4.0
20045171;271389;4;22.02.2023 00:00;104899;86860;18039;14.6
20045170;;4;23.02.2023 00:00;0;0;0;0.0
20045448;273735;4;23.02.2023 00:00;16897;8962;7935;1.5
20045458;268864;4;23.02.2023 00:00;68155;60900;7255;11.9
20045457;207511;4;24.02.2023 00:00;12113;11342;771;2.3
20045459;273743;4;24.02.2023 00:00;12359;11340;1019;2.4
20045514;282869;4;24.02.2023 00:00;77800;70560;7240;13.0
20045441;281857;4;24.02.2023 00:00;15930;5040;10890;0.9
20045566;202172;4;25.02.2023 00:00;33802;30242;3560;5.4
20045567;202175;4;27.02.2023 00:00;28850;22121;6729;4.0
20045617;277159;4;27.02.2023 00:00;47702;40467;7235;6.4
20045616;276642;4;28.02.2023 00:00;50680;41760;8920;7.7
20045618;277653;4;28.02.2023 00:00;22752;20738;2014;3.6
20045447;;4;28.02.2023 00:00;0;0;0;0.0
20045679;217889;4;28.02.2023 00:00;45397;31668;13729;7.9
20045722;276467;4;01.03.2023 00:00;13400;10192;3208;2.4
20045721;276330;4;01.03.2023 00:00;93080;82901;10179;17.9
20045930;282550;4;02.03.2023 00:00;32145;25345;6800;5.5
20045929;282344;4;03.03.2023 00:00;32155;27457;4698;6.0
20045647;;4;03.03.2023 00:00;0;0;0;0.0
20045766;273683;4;03.03.2023 00:00;39911;28608;11303;5.5
20045853;281373;4;04.03.2023 00:00;102972;82944;20028;15.6
20045926;283091;4;06.03.2023 00:00;119294;110208;9086;18.8
20046077;281619;4;07.03.2023 00:00;62855;50401;12454;9.5
20046078;282977;4;08.03.2023 00:00;34935;28224;6711;5.1
20046663;276087;4;09.03.2023 00:00;149045;138720;10325;22.7
20045928;;4;10.03.2023 00:00;0;0;0;0.0
20046185;250665;4;10.03.2023 00:00;28410;25256;3154;5.2
20046184;239271;4;10.03.2023 00:00;18515;16104;2411;3.1
20046888;281734;4;22.03.2023 00:00;36800;27456;9344;6.0
20046965;282198;4;23.03.2023 00:00;46610;37928;8682;9.2
20046966;282205;4;23.03.2023 00:00;18100;13200;4900;3.1
20046964;266239;4;24.03.2023 00:00;35690;26295;9395;8.0
20046963;264986;4;24.03.2023 00:00;33562;25482;8080;8.4
20047481;282828;4;27.03.2023 00:00;11447;10192;1255;2.3
20047086;279580;4;27.03.2023 00:00;13221;12194;1027;2.8
20047083;;4;27.03.2023 00:00;0;0;0;0.0
20047125;281746;4;27.03.2023 00:00;29671;23660;6011;4.4
20047126;281746;4;28.03.2023 00:00;27288;23100;4188;4.1
20047123;272250;4;28.03.2023 00:00;24000;27860;-3860;5.4
20047469;268864;4;28.03.2023 00:00;16500;6720;9780;1.1
20047085;268836;4;29.03.2023 00:00;52700;29400;23300;5.6
20047084;;4;29.03.2023 00:00;0;0;0;0.0
20047208;277657;4;30.03.2023 00:00;33700;27710;5990;4.8
20047218;222805;4;30.03.2023 00:00;56850;51456;5394;9.2
20047219;281528;4;31.03.2023 00:00;63300;51000;12300;9.4
20047740;279587;4;31.03.2023 00:00;12156;10712;1444;2.0
20047828;;4;31.03.2023 00:00;0;0;0;0.0
20047829;283836;4;03.04.2023 00:00;34892;26226;8666;5.5
20047830;283837;4;03.04.2023 00:00;32542;27370;5172;6.9
20047709;283179;4;04.04.2023 00:00;215760;190082;25678;40.0
20048410;;4;17.04.2023 00:00;0;0;0;0.0
20048644;270346;4;17.04.2023 00:00;47670;41472;6198;7.8
20048643;270345;4;18.04.2023 00:00;47123;40128;6995;7.4
20049143;283947;4;18.04.2023 00:00;27600;21168;6432;3.9
20048430;283664;4;18.04.2023 00:00;35685;26112;9573;4.9
20048432;283667;4;19.04.2023 00:00;28054;27650;404;4.8
20048493;282694;4;19.04.2023 00:00;113513;78090;35423;21.0
20048651;282695;4;21.04.2023 00:00;51945;35150;16795;9.5
20048650;282695;4;21.04.2023 00:00;32410;25080;7330;7.5
20048411;;4;22.04.2023 00:00;0;0;0;0.0
20048646;277329;4;01.05.2023 00:00;22830;11200;11630;2.3
20048649;281746;4;01.05.2023 00:00;28400;23380;5020;4.3
20048702;277330;4;01.05.2023 00:00;41700;40320;1380;7.0
20048754;283660;4;02.05.2023 00:00;36564;26180;10384;5.0
20048753;283657;4;02.05.2023 00:00;27183;26323;860;4.8
20049041;283178;4;02.05.2023 00:00;283985;253440;30545;51.0
20048429;;4;02.05.2023 00:00;0;0;0;0.0
20049434;283179;4;05.05.2023 00:00;137262;128659;8603;25.8
20049453;282705;4;06.05.2023 00:00;53930;44352;9578;9.0
20049493;238061;4;07.05.2023 00:00;72730;65736;6994;13.5
20049565;279581;4;07.05.2023 00:00;14702;10194;4508;2.3
20049564;276090;4;08.05.2023 00:00;11822;10194;1628;2.4
20049583;283723;4;08.05.2023 00:00;23930;16808;7122;3.5
20049584;283724;4;08.05.2023 00:00;29120;28160;960;5.7
20049582;283722;4;08.05.2023 00:00;17000;16632;368;3.0
20049681;212378;4;09.05.2023 00:00;22838;21827;1011;4.3
20049682;212378;4;09.05.2023 00:00;32371;28160;4211;6.3
20049686;259588;4;09.05.2023 00:00;16000;10450;5550;2.0
20049452;;4;09.05.2023 00:00;0;0;0;0.0
20049684;228638;4;10.05.2023 00:00;17990;10540;7450;2.1
20049685;228645;4;10.05.2023 00:00;30890;27200;3690;5.2
20049692;278126;4;10.05.2023 00:00;21000;10368;10632;2.0
20049691;278126;4;10.05.2023 00:00;19290;10560;8730;2.0
20049687;275888;4;11.05.2023 00:00;30628;27648;2980;4.9
20049690;278032;4;11.05.2023 00:00;12200;10560;1640;1.9
20049688;277264;4;11.05.2023 00:00;13750;12480;1270;2.0
20049689;277799;4;11.05.2023 00:00;33255;26496;6759;5.1
20049874;;4;12.05.2023 00:00;0;0;0;0.0
20050070;283178;4;12.05.2023 00:00;79255;63360;15895;13.5
20050071;283934;4;13.05.2023 00:00;28267;21035;7232;4.5
20050069;276332;4;13.05.2023 00:00;266032;245522;20510;49.7
20050377;273671;4;26.05.2023 00:00;128935;83514;45421;23.1
20050375;232087;4;31.05.2023 00:00;25444;22176;3268;7.4
20050379;283934;4;31.05.2023 00:00;91172;65032;26140;15.0
20050704;283179;4;01.06.2023 00:00;167239;150920;16319;32.2
20050900;279472;4;05.06.2023 00:00;31482;27808;3674;6.5
20050898;274582;4;05.06.2023 00:00;46244;33000;13244;8.3
20050933;251472;4;06.06.2023 00:00;38082;25025;13057;8.3
20050221;264158;4;06.06.2023 00:00;15500;11176;4324;2.5
20050376;249950;4;07.06.2023 00:00;50595;44000;6595;9.4
20050897;;4;07.06.2023 00:00;0;0;0;0.0
20050904;283879;4;08.06.2023 00:00;12083;10944;1139;2.3
20050899;275332;4;08.06.2023 00:00;16600;10656;5944;2.0
20050906;282740;4;08.06.2023 00:00;342220;307580;34640;55.4
20051408;282740;4;13.06.2023 00:00;60452;58942;1510;10.2
20050921;207508;4;13.06.2023 00:00;8740;5600;3140;1.4
20050918;273735;4;13.06.2023 00:00;67522;56002;11520;10.5
20051169;274655;4;14.06.2023 00:00;12150;9660;2490;1.9
20050901;282157;4;14.06.2023 00:00;49550;40600;8950;7.8
20050903;282657;4;15.06.2023 00:00;37337;32340;4997;6.4
20050902;282256;4;15.06.2023 00:00;28113;26880;1233;5.0
20051170;282161;4;15.06.2023 00:00;29827;26880;2947;5.4
20051839;277184;4;29.06.2023 00:00;73625;40320;33305;7.9
20051841;277315;4;30.06.2023 00:00;17749;11136;6613;2.6
20052178;;4;01.07.2023 00:00;0;0;0;0.0
20052179;276094;4;03.07.2023 00:00;119330;104286;15044;23.3
20052468;271211;4;03.07.2023 00:00;11148;5632;5516;1.4
20052235;276090;4;04.07.2023 00:00;17560;12740;4820;2.8
20052319;282828;4;04.07.2023 00:00;14832;13652;1180;3.1
20052318;277470;4;05.07.2023 00:00;32280;25116;7164;5.7
20052320;283015;4;05.07.2023 00:00;16153;10010;6143;2.3
20053023;279825;4;31.07.2023 00:00;35000;25344;9656;6.1
20053157;283178;4;31.07.2023 00:00;76990;71808;5182;15.2
20053021;284558;4;31.07.2023 00:00;800;440;360;0.2
20053347;283178;4;01.08.2023 00:00;62260;59136;3124;13.2
20053346;282198;4;02.08.2023 00:00;17502;16546;956;3.4
20053549;282198;4;02.08.2023 00:00;27869;25346;2523;5.4
20054102;282344;4;02.08.2023 00:00;26031;25344;687;5.3
20053422;276332;4;03.08.2023 00:00;165654;154880;10774;32.8
20053553;284542;4;04.08.2023 00:00;14833;10192;4641;2.2
20053551;231195;4;04.08.2023 00:00;15421;18480;-3059;6.8
20053550;230844;4;07.08.2023 00:00;21525;13376;8149;4.5
20053552;253378;4;07.08.2023 00:00;25860;18920;6940;5.8
20053635;276330;4;07.08.2023 00:00;97950;88270;9680;19.3
20053634;276094;4;08.08.2023 00:00;100350;88270;12080;19.2
20053633;276092;4;09.08.2023 00:00;33950;31941;2009;6.8
20054156;276093;4;10.08.2023 00:00;57716;51870;5846;10.7
20053631;276090;4;10.08.2023 00:00;13000;12740;260;2.9
20054251;276332;4;11.08.2023 00:00;170856;154002;16854;32.6
20054252;276332;4;14.08.2023 00:00;97622;92842;4780;20.0
20054253;280903;4;15.08.2023 00:00;27580;25344;2236;5.4
20054368;275888;4;15.08.2023 00:00;44100;30720;13380;6.2
20054349;;4;15.08.2023 00:00;0;0;0;0.0
20054444;266964;4;16.08.2023 00:00;46814;43778;3036;7.1
20054926;276060;4;03.09.2023 00:00;112430;103296;9134;18.0
20054927;276063;4;04.09.2023 00:00;168350;158016;10334;27.0
20055075;274294;4;05.09.2023 00:00;40868;38784;2084;6.5
20055156;;4;06.09.2023 00:00;0;0;0;0.0
20055159;277332;4;06.09.2023 00:00;18425;10945;7480;2.0
20055158;277331;4;06.09.2023 00:00;12044;10944;1100;2.0
20055157;;4;06.09.2023 00:00;0;0;0;0.0
20055218;276330;4;07.09.2023 00:00;20433;13832;6601;3.7
20055698;276330;4;07.09.2023 00:00;64930;58604;6326;12.5
20055220;276092;4;08.09.2023 00:00;85771;67795;17976;14.3
20055221;276094;4;08.09.2023 00:00;93308;84084;9224;18.0
20055700;276467;4;19.09.2023 00:00;21310;17836;3474;3.9
20055741;238061;4;20.09.2023 00:00;79609;70488;9121;15.5
20055699;276090;4;20.09.2023 00:00;15000;15288;-288;3.5
20055946;280129;4;28.09.2023 00:00;36945;25608;11337;6.5
20055948;282198;4;30.09.2023 00:00;38255;25344;12911;6.4
20055950;282705;4;30.09.2023 00:00;22960;19008;3952;4.6
20055949;282705;4;30.09.2023 00:00;68521;61514;7007;13.6
20055947;281114;4;01.10.2023 00:00;33080;27456;5624;7.0
20055952;283179;4;02.10.2023 00:00;37806;35904;1902;8.4
20056642;276332;4;02.10.2023 00:00;141314;123288;18026;27.9
20055951;282828;4;04.10.2023 00:00;14831;10192;4639;2.4
20057841;285695;4;31.10.2023 00:00;76310;70345;5965;16.4
20057842;285661;4;01.11.2023 00:00;5460;5460;0;1.8
20058163;285787;4;01.11.2023 00:00;5187;5187;0;1.2
20058162;285786;4;01.11.2023 00:00;5462;5462;0;1.2
20058164;285788;4;01.11.2023 00:00;5460;5460;0;1.6
20042210;281113;5;03.01.2023 00:00;147594;126986;20608;13.4
20042211;281113;5;03.01.2023 00:00;66800;63360;3440;6.5
20042208;247185;5;04.01.2023 00:00;31276;25082;6194;2.9
20042209;267237;5;04.01.2023 00:00;11216;6670;4546;1.0
20042206;247183;5;04.01.2023 00:00;32080;25344;6736;3.1
20042207;247184;5;04.01.2023 00:00;27199;25344;1855;3.0
20042205;247182;5;04.01.2023 00:00;27900;25344;2556;3.1
20041989;282078;5;05.01.2023 00:00;36103;26314;9789;2.7
20041988;280154;5;05.01.2023 00:00;76040;65023;11017;6.1
20042039;282078;5;05.01.2023 00:00;34692;27326;7366;2.7
20042036;272025;5;06.01.2023 00:00;31506;25302;6204;3.0
20042037;281406;5;06.01.2023 00:00;45732;39723;6009;4.0
20042189;281416;5;06.01.2023 00:00;30100;25553;4547;2.4
20042038;281416;5;06.01.2023 00:00;31002;25302;5700;2.4
20042750;281416;5;06.01.2023 00:00;73504;71095;2409;6.6
20042183;281791;5;07.01.2023 00:00;31032;25302;5730;2.9
20042182;275248;5;07.01.2023 00:00;41471;33649;7822;3.3
20042186;281409;5;07.01.2023 00:00;30705;25300;5405;2.6
20042184;281414;5;07.01.2023 00:00;30257;25300;4957;2.7
20042187;277697;5;07.01.2023 00:00;84185;79192;4993;7.2
20042752;262838;5;08.01.2023 00:00;26810;25302;1508;2.7
20042751;227487;5;08.01.2023 00:00;36939;29570;7369;3.1
20042753;;5;08.01.2023 00:00;0;0;0;0.0
20042885;282403;5;08.01.2023 00:00;44832;33182;11650;4.1
20042886;264700;5;09.01.2023 00:00;46955;28224;18731;3.6
20042887;279405;5;09.01.2023 00:00;56351;48386;7965;5.6
20042888;268029;5;09.01.2023 00:00;27652;24642;3010;2.3
20042889;279019;5;09.01.2023 00:00;32800;23596;9204;2.7
20042894;279019;5;10.01.2023 00:00;38226;28656;9570;3.1
20042891;280473;5;10.01.2023 00:00;33502;25058;8444;2.7
20042890;275073;5;10.01.2023 00:00;32911;25632;7279;3.3
20042892;273166;5;10.01.2023 00:00;31454;26352;5102;2.5
20042893;272565;5;11.01.2023 00:00;70620;48386;22234;5.3
20042895;275069;5;11.01.2023 00:00;21095;20162;933;2.5
20042898;272054;5;11.01.2023 00:00;122680;101088;21592;9.3
20042800;;5;12.01.2023 00:00;0;0;0;0.0
20043481;271168;5;12.01.2023 00:00;17419;10514;6905;1.5
20042906;274391;5;12.01.2023 00:00;61664;46082;15582;5.8
20042907;279086;5;13.01.2023 00:00;81483;70850;10633;7.8
20042905;272644;5;13.01.2023 00:00;13502;10946;2556;1.3
20042904;272643;5;13.01.2023 00:00;105038;100226;4812;9.9
20042902;271996;5;13.01.2023 00:00;15533;11088;4445;1.3
20043029;273231;5;14.01.2023 00:00;17926;10370;7556;1.4
20043028;271741;5;14.01.2023 00:00;19944;16130;3814;1.7
20043032;279085;5;14.01.2023 00:00;16127;15986;141;1.7
20043031;278243;5;14.01.2023 00:00;26139;23040;3099;2.3
20042903;272069;5;15.01.2023 00:00;15002;10946;4056;1.1
20042901;271981;5;15.01.2023 00:00;17787;12386;5401;1.2
20043027;207805;5;15.01.2023 00:00;28500;25344;3156;3.6
20043030;277330;5;15.01.2023 00:00;68102;61042;7060;6.6
20043036;282256;5;16.01.2023 00:00;40222;33322;6900;3.5
20043035;282255;5;16.01.2023 00:00;38825;33040;5785;3.3
20043033;281570;5;16.01.2023 00:00;72055;64543;7512;8.3
20043037;282259;5;16.01.2023 00:00;113963;101920;12043;10.6
20042799;;5;17.01.2023 00:00;0;0;0;0.0
20043186;282179;5;17.01.2023 00:00;556621;507456;49165;51.4
20043034;281927;5;17.01.2023 00:00;39358;26499;12859;4.0
20043846;228635;5;20.01.2023 00:00;26406;26180;226;2.9
20042882;228636;5;20.01.2023 00:00;12502;10202;2300;1.3
20043225;281732;5;21.01.2023 00:00;152116;134640;17476;14.1
20042485;;5;21.01.2023 00:00;0;0;0;0.0
20043343;253217;5;22.01.2023 00:00;157497;132004;25493;16.1
20043350;275371;5;23.01.2023 00:00;82593;69696;12897;7.2
20043351;275373;5;23.01.2023 00:00;127471;115194;12277;11.4
20044008;271013;5;24.01.2023 00:00;59547;52998;6549;5.2
20043980;278176;5;24.01.2023 00:00;14500;9506;4994;1.1
20043231;;5;24.01.2023 00:00;0;0;0;0.0
20043422;282746;5;24.01.2023 00:00;28871;20243;8628;2.2
20043977;280575;5;24.01.2023 00:00;22178;22178;0;2.9
20043420;281414;5;25.01.2023 00:00;31676;28592;3084;3.0
20043421;281503;5;25.01.2023 00:00;25858;25302;556;2.8
20043539;272017;5;25.01.2023 00:00;129647;111936;17711;13.4
20043538;272016;5;26.01.2023 00:00;122763;111408;11355;12.9
20043540;272018;5;27.01.2023 00:00;116942;111938;5004;12.7
20043543;272021;5;27.01.2023 00:00;118884;111410;7474;11.8
20043542;272020;5;28.01.2023 00:00;118827;107976;10851;12.4
20043541;272019;5;29.01.2023 00:00;114436;110618;3818;12.3
20043572;282844;5;30.01.2023 00:00;32144;29568;2576;5.2
20043283;;5;30.01.2023 00:00;0;0;0;0.0
20043653;282403;5;31.01.2023 00:00;64000;55020;8980;6.1
20044012;278180;5;31.01.2023 00:00;9628;10080;-452;1.5
20043654;282403;5;31.01.2023 00:00;7000;5600;1400;0.5
20044010;278178;5;31.01.2023 00:00;10598;7280;3318;0.9
20044009;278177;5;31.01.2023 00:00;13932;10080;3852;1.3
20044011;278179;5;31.01.2023 00:00;8202;7282;920;0.9
20043651;239375;5;01.02.2023 00:00;28500;26208;2292;3.1
20043785;279803;5;01.02.2023 00:00;30902;26210;4692;3.0
20044148;;5;01.02.2023 00:00;0;0;0;0.0
20043784;279416;5;01.02.2023 00:00;61502;54722;6780;6.8
20043960;283038;5;02.02.2023 00:00;113152;100370;12782;9.8
20043786;282837;5;02.02.2023 00:00;31104;31104;0;5.7
20044150;281918;5;03.02.2023 00:00;5042;5042;0;3.0
20043652;274802;5;03.02.2023 00:00;17090;10369;6721;1.7
20044149;281916;5;03.02.2023 00:00;5042;5042;0;3.3
20043919;274802;5;04.02.2023 00:00;42306;40322;1984;4.7
20043889;271739;5;04.02.2023 00:00;32042;25922;6120;3.1
20043890;274391;5;04.02.2023 00:00;79350;71424;7926;7.9
20043650;;5;05.02.2023 00:00;0;0;0;0.0
20044156;279403;5;05.02.2023 00:00;50531;38722;11809;4.6
20044157;279403;5;05.02.2023 00:00;52300;46706;5594;4.8
20044155;276802;5;05.02.2023 00:00;56200;52272;3928;5.8
20044617;282677;5;05.02.2023 00:00;112953;104546;8407;10.3
20044473;282677;5;06.02.2023 00:00;58000;52756;5244;5.1
20044468;268797;5;06.02.2023 00:00;55869;52274;3595;5.3
20044154;275373;5;07.02.2023 00:00;154833;127534;27299;13.1
20044410;275371;5;07.02.2023 00:00;116533;102608;13925;9.8
20043961;283054;5;08.02.2023 00:00;77354;58800;18554;6.3
20043957;;5;08.02.2023 00:00;0;0;0;0.0
20043922;281696;5;09.02.2023 00:00;55467;52922;2545;5.1
20043921;280594;5;09.02.2023 00:00;22669;17640;5029;1.7
20043920;280565;5;10.02.2023 00:00;58425;52920;5505;4.6
20045346;280594;5;10.02.2023 00:00;55138;52922;2216;5.1
20044738;;5;10.02.2023 00:00;0;0;0;0.0
20043923;281697;5;10.02.2023 00:00;58462;52922;5540;5.0
20044807;281655;5;11.02.2023 00:00;33538;25344;8194;3.7
20044418;281912;5;11.02.2023 00:00;5016;5016;0;6.6
20044408;212520;5;11.02.2023 00:00;37209;26400;10809;3.4
20044412;282462;5;12.02.2023 00:00;48336;39723;8613;4.5
20044798;282667;5;12.02.2023 00:00;28044;25555;2489;2.8
20044797;272025;5;12.02.2023 00:00;30596;25302;5294;3.0
20044407;202158;5;12.02.2023 00:00;35430;27192;8238;2.7
20044471;282258;5;13.02.2023 00:00;73912;66530;7382;7.4
20045292;282206;5;13.02.2023 00:00;21200;17952;3248;2.8
20044470;282258;5;13.02.2023 00:00;68326;66528;1798;7.5
20044658;265001;5;14.02.2023 00:00;54449;51218;3231;5.9
20044444;215571;5;14.02.2023 00:00;31667;29568;2099;3.3
20044409;215570;5;14.02.2023 00:00;33253;25874;7379;2.5
20044153;228104;5;14.02.2023 00:00;60932;54344;6588;6.6
20044808;;5;15.02.2023 00:00;0;0;0;0.0
20044811;275373;5;15.02.2023 00:00;259424;220704;38720;21.3
20044624;;5;16.02.2023 00:00;0;0;0;0.0
20044876;280895;5;16.02.2023 00:00;220665;193052;27613;18.4
20044892;280941;5;17.02.2023 00:00;171972;156785;15187;14.4
20045003;280919;5;18.02.2023 00:00;239662;214502;25160;20.0
20044997;280943;5;19.02.2023 00:00;71365;64353;7012;6.2
20044996;280918;5;19.02.2023 00:00;70078;64350;5728;5.6
20044995;276810;5;20.02.2023 00:00;69254;64352;4902;6.0
20045074;279506;5;20.02.2023 00:00;414987;386100;28887;34.6
20044998;283173;5;22.02.2023 00:00;113554;107250;6304;9.5
20045174;283173;5;22.02.2023 00:00;62102;64352;-2250;5.8
20045076;283166;5;23.02.2023 00:00;68415;64352;4063;6.0
20045173;283166;5;23.02.2023 00:00;89450;85802;3648;7.6
20045306;283165;5;23.02.2023 00:00;113106;107252;5854;9.9
20045444;283165;5;24.02.2023 00:00;89095;85800;3295;7.6
20045445;283167;5;24.02.2023 00:00;69410;64350;5060;5.9
20045443;282864;5;24.02.2023 00:00;583820;557700;26120;49.4
20045927;283166;5;27.02.2023 00:00;115802;107250;8552;9.6
20046037;283166;5;27.02.2023 00:00;108410;107252;1158;9.4
20045732;278609;5;27.02.2023 00:00;71002;64353;6649;6.1
20046057;280941;5;28.02.2023 00:00;458223;429002;29221;39.4
20045307;;5;02.03.2023 00:00;0;0;0;0.0
20045565;271013;5;02.03.2023 00:00;163272;148106;15166;13.2
20046327;268027;5;03.03.2023 00:00;39103;34848;4255;3.8
20045619;277975;5;03.03.2023 00:00;356930;332645;24285;30.1
20045767;277975;5;05.03.2023 00:00;355665;332642;23023;29.7
20045852;277975;5;06.03.2023 00:00;354163;332640;21523;29.5
20045925;275373;5;08.03.2023 00:00;264044;239098;24946;22.0
20046009;275371;5;09.03.2023 00:00;169273;153912;15361;14.0
20046083;275371;5;10.03.2023 00:00;95321;85186;10135;7.8
20046082;283258;5;10.03.2023 00:00;19180;20066;-886;4.0
20046797;;5;10.03.2023 00:00;0;0;0;0.0
20046900;271104;5;10.03.2023 00:00;649598;605880;43718;55.8
20046643;282160;5;13.03.2023 00:00;29736;25346;4390;2.9
20046645;282542;5;13.03.2023 00:00;19163;12675;6488;1.6
20046646;282543;5;14.03.2023 00:00;77219;63360;13859;7.3
20046647;282543;5;14.03.2023 00:00;65002;63362;1640;6.7
20046641;273120;5;15.03.2023 00:00;28772;25346;3426;2.8
20046648;283323;5;15.03.2023 00:00;19802;17954;1848;2.0
20046644;282206;5;15.03.2023 00:00;28200;25344;2856;3.1
20046161;;5;15.03.2023 00:00;0;0;0;0.0
20046264;283255;5;15.03.2023 00:00;10222;10222;0;3.8
20046263;283247;5;16.03.2023 00:00;7282;7282;0;9.4
20046178;282255;5;16.03.2023 00:00;44731;31360;13371;4.0
20046179;282256;5;17.03.2023 00:00;76018;65242;10776;8.2
20046391;283566;5;17.03.2023 00:00;37594;33040;4554;3.6
20046390;282657;5;17.03.2023 00:00;146003;130482;15521;15.1
20046174;273057;5;18.03.2023 00:00;70318;54146;16172;6.0
20046173;273056;5;18.03.2023 00:00;13004;11232;1772;1.1
20046172;273053;5;18.03.2023 00:00;28266;21168;7098;2.3
20046175;273058;5;19.03.2023 00:00;12019;10370;1649;1.3
20046171;273051;5;19.03.2023 00:00;32689;31680;1009;3.4
20047375;210879;5;19.03.2023 00:00;80799;76682;4117;7.6
20047215;207440;5;20.03.2023 00:00;17550;12848;4702;1.4
20046259;276740;5;20.03.2023 00:00;62382;50547;11835;5.5
20047395;207440;5;20.03.2023 00:00;10252;10802;-550;1.1
20046358;259466;5;21.03.2023 00:00;279054;250540;28514;27.0
20047049;;5;22.03.2023 00:00;0;0;0;0.0
20046968;282403;5;23.03.2023 00:00;79460;67200;12260;9.7
20046389;;5;23.03.2023 00:00;0;0;0;0.0
20046887;281137;5;23.03.2023 00:00;145433;123482;21951;12.5
20046889;283054;5;24.03.2023 00:00;188513;164640;23873;16.4
20046886;;5;25.03.2023 00:00;0;0;0;0.0
20047061;268027;5;25.03.2023 00:00;58459;43562;14897;4.5
20047178;283565;5;25.03.2023 00:00;114599;104546;10053;10.8
20047177;283543;5;26.03.2023 00:00;228736;209332;19404;21.8
20047062;275371;5;27.03.2023 00:00;127336;114226;13110;11.1
20047063;275373;5;28.03.2023 00:00;469333;425925;43408;40.1
20046843;282670;5;30.03.2023 00:00;46825;39721;7104;3.6
20047052;;5;30.03.2023 00:00;0;0;0;0.0
20046842;278322;5;30.03.2023 00:00;31175;27722;3453;2.9
20048083;268857;5;30.03.2023 00:00;29048;17688;11360;3.0
20046967;228104;5;31.03.2023 00:00;57502;56014;1488;6.5
20047373;263773;5;31.03.2023 00:00;31592;25203;6389;3.3
20047050;;5;31.03.2023 00:00;0;0;0;0.0
20046177;282159;5;01.04.2023 00:00;38438;25623;12815;3.6
20046176;282157;5;01.04.2023 00:00;73594;63840;9754;7.3
20046262;282161;5;02.04.2023 00:00;29047;25202;3845;3.4
20047483;283247;5;02.04.2023 00:00;7282;7282;0;5.8
20046257;271622;5;02.04.2023 00:00;73733;60048;13685;6.9
20047588;283698;5;03.04.2023 00:00;53868;46083;7785;5.5
20048350;275221;5;03.04.2023 00:00;28251;22176;6075;2.1
20047591;271983;5;03.04.2023 00:00;28493;25920;2573;2.2
20047593;272643;5;03.04.2023 00:00;24500;21312;3188;2.0
20047594;274802;5;04.04.2023 00:00;12400;10800;1600;1.0
20047482;;5;04.04.2023 00:00;0;0;0;0.0
20047592;272068;5;04.04.2023 00:00;18627;13682;4945;1.8
20047586;280565;5;04.04.2023 00:00;114632;88200;26432;9.0
20047885;281696;5;05.04.2023 00:00;58188;52922;5266;5.1
20047887;283054;5;05.04.2023 00:00;157819;135240;22579;12.8
20047886;281697;5;06.04.2023 00:00;59062;52923;6139;5.3
20048408;283847;5;06.04.2023 00:00;0;0;0;0.0
20047788;;5;06.04.2023 00:00;0;0;0;0.0
20048678;283847;5;06.04.2023 00:00;290512;252406;38106;24.0
20048595;283950;5;12.04.2023 00:00;432534;409706;22828;36.9
20048659;282677;5;13.04.2023 00:00;119364;113256;6108;10.3
20048402;;5;14.04.2023 00:00;0;0;0;0.0
20047789;277055;5;14.04.2023 00:00;133046;115104;17942;15.6
20047790;277058;5;15.04.2023 00:00;17051;15842;1209;2.4
20048186;282698;5;15.04.2023 00:00;37100;25080;12020;3.6
20048407;282696;5;16.04.2023 00:00;40000;25080;14920;4.3
20048187;282078;5;16.04.2023 00:00;37219;25808;11411;2.8
20048269;280154;5;16.04.2023 00:00;100130;92598;7532;9.0
20048270;281409;5;17.04.2023 00:00;37929;28591;9338;3.2
20048403;281414;5;17.04.2023 00:00;27319;25302;2017;3.0
20048409;281410;5;17.04.2023 00:00;45658;40229;5429;4.1
20048406;282462;5;17.04.2023 00:00;45100;39722;5378;4.2
20048404;281791;5;17.04.2023 00:00;29262;25302;3960;2.6
20048405;282462;5;18.04.2023 00:00;44279;39723;4556;4.0
20048438;283331;5;18.04.2023 00:00;33212;25300;7912;3.0
20048435;281416;5;18.04.2023 00:00;33326;31119;2207;2.8
20048434;281416;5;18.04.2023 00:00;30940;25300;5640;2.4
20048436;283207;5;19.04.2023 00:00;28066;25808;2258;2.6
20048437;283207;5;19.04.2023 00:00;43150;39721;3429;4.0
20048433;262838;5;19.04.2023 00:00;30176;25300;4876;2.9
20048439;282160;5;19.04.2023 00:00;45050;25344;19706;3.3
20048440;282201;5;20.04.2023 00:00;37763;25347;12416;3.8
20048441;282258;5;20.04.2023 00:00;112902;100320;12582;11.9
20048489;236415;5;21.04.2023 00:00;21498;17480;4018;2.2
20048492;280443;5;21.04.2023 00:00;12800;10120;2680;1.7
20048488;236414;5;21.04.2023 00:00;39182;35192;3990;4.1
20048491;266301;5;21.04.2023 00:00;40107;34962;5145;3.8
20048490;266299;5;22.04.2023 00:00;20727;17482;3245;1.9
20048953;272021;5;22.04.2023 00:00;69770;65474;4296;7.6
20048952;272020;5;22.04.2023 00:00;69706;63362;6344;7.4
20048532;271104;5;23.04.2023 00:00;62698;50160;12538;5.4
20048534;283738;5;23.04.2023 00:00;15215;10370;4845;1.9
20048531;;5;23.04.2023 00:00;0;0;0;0.0
20048533;272643;5;23.04.2023 00:00;29701;23040;6661;3.1
20048656;280403;5;24.04.2023 00:00;34156;25776;8380;3.5
20048645;275219;5;24.04.2023 00:00;11300;10224;1076;1.2
20048648;280407;5;24.04.2023 00:00;55685;40897;14788;4.7
20048647;279088;5;24.04.2023 00:00;36776;30531;6245;2.8
20049052;283973;5;25.04.2023 00:00;84449;69122;15327;9.4
20048653;283255;5;25.04.2023 00:00;10080;10080;0;3.7
20049051;275858;5;26.04.2023 00:00;10992;9939;1053;0.9
20048657;282549;5;26.04.2023 00:00;28553;26882;1671;3.5
20048658;283929;5;27.04.2023 00:00;20162;20162;0;8.2
20048661;;5;27.04.2023 00:00;0;0;0;0.0
20049036;283027;5;27.04.2023 00:00;40800;28080;12720;2.6
20049441;283350;5;27.04.2023 00:00;168879;105300;63579;11.3
20048943;283971;5;29.04.2023 00:00;15600;15600;0;8.0
20048942;283968;5;29.04.2023 00:00;15600;15600;0;4.1
20048941;;5;29.04.2023 00:00;0;0;0;0.0
20048655;282864;5;29.04.2023 00:00;342417;300300;42117;29.1
20048750;282864;5;01.05.2023 00:00;354523;321750;32773;30.1
20049001;282864;5;02.05.2023 00:00;111032;107252;3780;9.5
20049002;282864;5;02.05.2023 00:00;189642;171602;18040;15.8
20048965;282864;5;03.05.2023 00:00;126240;107252;18988;10.3
20049356;283165;5;04.05.2023 00:00;345514;321752;23762;30.0
20049355;283165;5;06.05.2023 00:00;210441;193050;17391;17.2
20049431;283165;5;07.05.2023 00:00;108360;107250;1110;9.6
20049432;283166;5;07.05.2023 00:00;159462;150152;9310;13.4
20049875;282403;5;08.05.2023 00:00;37800;37800;0;11.5
20049044;;5;08.05.2023 00:00;0;0;0;0.0
20049442;266105;5;08.05.2023 00:00;40843;29402;11441;4.1
20049046;259466;5;09.05.2023 00:00;87302;60530;26772;7.6
20049045;;5;09.05.2023 00:00;0;0;0;0.0
20049876;;5;09.05.2023 00:00;0;0;0;0.0
20049693;283950;5;10.05.2023 00:00;220885;191666;29219;19.4
20049664;;5;10.05.2023 00:00;0;0;0;0.0
20049498;283948;5;11.05.2023 00:00;25488;20064;5424;2.6
20049499;283949;5;11.05.2023 00:00;24671;20858;3813;2.6
20049494;278213;5;11.05.2023 00:00;35388;25344;10044;3.4
20049568;282113;5;11.05.2023 00:00;152917;133324;19593;14.9
20049586;281113;5;12.05.2023 00:00;85802;75770;10032;8.8
20049683;216599;5;15.05.2023 00:00;38350;31418;6932;4.0
20049911;261525;5;15.05.2023 00:00;30654;25304;5350;2.9
20049916;283331;5;16.05.2023 00:00;30547;25302;5245;2.7
20049913;281544;5;16.05.2023 00:00;43928;40733;3195;3.7
20049914;282667;5;16.05.2023 00:00;65819;60722;5097;5.9
20049915;282670;5;16.05.2023 00:00;206242;199366;6876;18.4
20049912;281406;5;17.05.2023 00:00;131110;120428;10682;10.8
20049918;282200;5;18.05.2023 00:00;32892;26402;6490;3.1
20050025;284152;5;18.05.2023 00:00;43130;32472;10658;3.2
20050023;;5;19.05.2023 00:00;0;0;0;0.0
20050029;277213;5;19.05.2023 00:00;23887;19299;4588;2.2
20050026;274522;5;19.05.2023 00:00;212343;172084;40259;17.9
20050028;275069;5;20.05.2023 00:00;38145;27936;10209;2.8
20050027;274523;5;20.05.2023 00:00;58317;52420;5897;5.2
20050030;279156;5;21.05.2023 00:00;235308;199298;36010;20.2
20050078;283447;5;22.05.2023 00:00;29459;24194;5265;2.6
20050079;284050;5;22.05.2023 00:00;79543;78336;1207;7.4
20050096;272565;5;22.05.2023 00:00;54091;52419;1672;4.9
20050452;284264;5;23.05.2023 00:00;166832;149763;17069;14.2
20050095;270339;5;24.05.2023 00:00;19116;13826;5290;1.2
20050117;;5;24.05.2023 00:00;0;0;0;0.0
20050024;276271;5;24.05.2023 00:00;33150;25632;7518;3.0
20050237;284116;5;24.05.2023 00:00;40039;31683;8356;3.6
20050193;259466;5;24.05.2023 00:00;194867;165360;29507;17.9
20050231;;5;26.05.2023 00:00;0;0;0;0.0
20050701;279153;5;26.05.2023 00:00;100563;84242;16321;7.9
20050380;274510;5;26.05.2023 00:00;49444;39002;10442;3.7
20050381;279155;5;26.05.2023 00:00;33000;28080;4920;3.2
20051114;280918;5;27.05.2023 00:00;139689;107250;32439;10.3
20050232;;5;27.05.2023 00:00;0;0;0;0.0
20050384;280942;5;28.05.2023 00:00;114552;107252;7300;10.1
20051115;280919;5;28.05.2023 00:00;93200;85800;7400;7.7
20051008;283042;5;28.05.2023 00:00;116274;107254;9020;9.9
20050230;;5;29.05.2023 00:00;0;0;0;0.0
20050240;281137;5;29.05.2023 00:00;178284;135240;43044;12.7
20050695;281696;5;30.05.2023 00:00;64650;52921;11729;5.1
20050694;280594;5;30.05.2023 00:00;84533;52920;31613;5.3
20050693;280565;5;31.05.2023 00:00;85943;76440;9503;7.4
20050239;279583;5;31.05.2023 00:00;18040;10203;7837;1.4
20050236;;5;31.05.2023 00:00;0;0;0;0.0
20050699;;5;01.06.2023 00:00;0;0;0;0.0
20050238;276088;5;01.06.2023 00:00;17982;16322;1660;1.8
20050776;283331;5;01.06.2023 00:00;200997;174321;26676;16.4
20050774;282462;5;02.06.2023 00:00;252509;240856;11653;21.3
20050895;281503;5;03.06.2023 00:00;30744;25300;5444;2.2
20050896;283987;5;03.06.2023 00:00;45403;40480;4923;3.8
20050894;281416;5;03.06.2023 00:00;151172;140672;10500;12.6
20050773;281728;5;04.06.2023 00:00;35375;27720;7655;3.1
20050706;268858;5;04.06.2023 00:00;33502;31682;1820;3.6
20050775;282542;5;04.06.2023 00:00;37370;26930;10440;2.8
20050705;268856;5;05.06.2023 00:00;41585;30099;11486;4.0
20050700;270071;5;05.06.2023 00:00;256152;221235;34917;23.8
20051194;;5;07.06.2023 00:00;0;0;0;0.0
20051195;283950;5;07.06.2023 00:00;280386;261360;19026;23.2
20051295;283847;5;08.06.2023 00:00;105623;98738;6885;8.9
20051043;283173;5;08.06.2023 00:00;200899;171602;29297;16.6
20050984;;5;08.06.2023 00:00;0;0;0;0.0
20051042;283166;5;09.06.2023 00:00;96434;85800;10634;8.1
20051045;284322;5;10.06.2023 00:00;480584;450455;30129;39.7
20051040;283042;5;12.06.2023 00:00;252976;235952;17024;20.4
20050697;283920;5;13.06.2023 00:00;76126;64350;11776;5.9
20050698;283922;5;14.06.2023 00:00;68933;64350;4583;6.0
20051046;;5;14.06.2023 00:00;0;0;0;0.0
20051656;280404;5;14.06.2023 00:00;52887;41762;11125;4.1
20051061;284123;5;14.06.2023 00:00;122057;96484;25573;13.0
20051676;284377;5;16.06.2023 00:00;18343;15123;3220;1.6
20051188;284363;5;16.06.2023 00:00;41066;28803;12263;3.3
20051060;;5;16.06.2023 00:00;0;0;0;0.0
20051679;279144;5;17.06.2023 00:00;137440;94180;43260;12.3
20051173;275069;5;19.06.2023 00:00;57837;48386;9451;4.7
20051678;274522;5;19.06.2023 00:00;24300;19584;4716;2.3
20051178;283822;5;20.06.2023 00:00;26838;24336;2502;2.3
20051177;281644;5;20.06.2023 00:00;27500;24192;3308;2.6
20051172;272191;5;20.06.2023 00:00;28747;24194;4553;2.4
20051174;275764;5;20.06.2023 00:00;29784;24194;5590;2.5
20051176;280473;5;20.06.2023 00:00;23172;19874;3298;2.0
20051175;279019;5;21.06.2023 00:00;75640;72576;3064;7.1
20051680;283530;5;21.06.2023 00:00;79113;72576;6537;7.1
20052100;274523;5;22.06.2023 00:00;113199;106563;6636;9.9
20051235;284048;5;22.06.2023 00:00;32225;28224;4001;2.7
20051234;283848;5;22.06.2023 00:00;27719;22179;5540;2.5
20051296;282403;5;23.06.2023 00:00;283578;240100;43478;25.3
20051410;;5;26.06.2023 00:00;0;0;0;0.0
20052438;284582;5;26.06.2023 00:00;407;407;0;3.4
20051451;283328;5;26.06.2023 00:00;77245;59141;18104;7.1
20051974;282400;5;27.06.2023 00:00;33088;25344;7744;3.2
20051556;284004;5;27.06.2023 00:00;34037;25050;8987;2.6
20051448;281544;5;28.06.2023 00:00;46370;41492;4878;3.7
20051965;;5;28.06.2023 00:00;0;0;0;0.0
20051975;284461;5;28.06.2023 00:00;5282;5282;0;0.7
20051830;283951;5;28.06.2023 00:00;273005;214898;58107;20.9
20052119;280594;5;30.06.2023 00:00;66738;52922;13816;5.6
20051799;;5;30.06.2023 00:00;0;0;0;0.0
20052568;283054;5;30.06.2023 00:00;114934;105840;9094;9.9
20052121;284233;5;01.07.2023 00:00;195;195;0;2.2
20051968;;5;02.07.2023 00:00;0;0;0;0.0
20052337;282694;5;02.07.2023 00:00;34195;15012;19183;2.5
20052120;283665;5;03.07.2023 00:00;42709;36865;5844;3.9
20052226;280970;5;03.07.2023 00:00;36539;25842;10697;2.8
20052182;276087;5;03.07.2023 00:00;32432;25161;7271;3.4
20052184;273545;5;03.07.2023 00:00;32292;30722;1570;3.6
20052183;276102;5;04.07.2023 00:00;25016;15810;9206;1.7
20052353;284595;5;04.07.2023 00:00;1152;1152;0;1.1
20052352;284594;5;04.07.2023 00:00;1152;1152;0;3.2
20052118;;5;04.07.2023 00:00;0;0;0;0.0
20052349;284543;5;04.07.2023 00:00;23850;19600;4250;2.9
20052599;202175;5;10.07.2023 00:00;56115;50401;5714;5.6
20052602;210879;5;10.07.2023 00:00;48103;45363;2740;4.9
20052348;283038;5;10.07.2023 00:00;54262;50690;3572;5.4
20052236;283327;5;11.07.2023 00:00;207988;190826;17162;19.7
20052350;283720;5;12.07.2023 00:00;46278;38882;7396;4.6
20052615;;5;12.07.2023 00:00;0;0;0;0.0
20052600;;5;12.07.2023 00:00;0;0;0;0.0
20052970;280594;5;12.07.2023 00:00;129084;105840;23244;10.4
20052971;252623;5;13.07.2023 00:00;31364;26042;5322;3.2
20052969;;5;13.07.2023 00:00;0;0;0;0.0
20052972;258872;5;13.07.2023 00:00;11575;10790;785;0.9
20052965;;5;13.07.2023 00:00;0;0;0;0.0
20052973;259201;5;13.07.2023 00:00;23527;20834;2693;2.0
20052603;271104;5;14.07.2023 00:00;352498;316807;35691;30.9
20052745;262477;5;17.07.2023 00:00;31413;25872;5541;3.4
20052747;282696;5;17.07.2023 00:00;16860;15050;1810;2.2
20052748;282698;5;17.07.2023 00:00;24594;15050;9544;1.8
20053152;284833;5;18.07.2023 00:00;2376;2376;0;2.1
20052966;284553;5;18.07.2023 00:00;5565;2907;2658;3.3
20052746;278211;5;18.07.2023 00:00;31844;25345;6499;3.2
20052809;283323;5;18.07.2023 00:00;29902;25346;4556;2.7
20052807;278212;5;18.07.2023 00:00;30180;25346;4834;2.9
20052960;236159;5;19.07.2023 00:00;29054;18402;10652;2.2
20052808;278213;5;19.07.2023 00:00;26648;25346;1302;3.2
20052964;236671;5;19.07.2023 00:00;22300;17710;4590;1.8
20052958;236157;5;19.07.2023 00:00;69603;66245;3358;7.0
20052962;236161;5;20.07.2023 00:00;73954;70382;3572;6.6
20052959;236158;5;20.07.2023 00:00;19739;18170;1569;2.0
20052963;236670;5;20.07.2023 00:00;12612;11042;1570;1.2
20052961;236160;5;20.07.2023 00:00;21272;18402;2870;2.2
20052968;;5;20.07.2023 00:00;0;0;0;0.0
20053153;283973;5;20.07.2023 00:00;66365;51844;14521;5.5
20053070;276479;5;21.07.2023 00:00;37883;27720;10163;3.2
20053066;268665;5;21.07.2023 00:00;17031;17780;-749;1.8
20053069;274675;5;21.07.2023 00:00;13308;11200;2108;1.5
20053068;271312;5;21.07.2023 00:00;13421;11103;2318;1.4
20053109;;5;22.07.2023 00:00;0;0;0;0.0
20053067;268675;5;22.07.2023 00:00;31856;27720;4136;3.2
20053071;278876;5;24.07.2023 00:00;42912;29642;13270;3.6
20053370;283568;5;24.07.2023 00:00;48354;40172;8182;3.8
20053099;272745;5;24.07.2023 00:00;51249;42121;9128;4.0
20053100;277285;5;25.07.2023 00:00;34977;30031;4946;3.0
20053075;284191;5;25.07.2023 00:00;66879;61623;5256;6.0
20053194;;5;25.07.2023 00:00;0;0;0;0.0
20053318;284721;5;25.07.2023 00:00;36660;36660;0;8.0
20053319;284719;5;26.07.2023 00:00;35100;35100;0;6.9
20053729;276810;5;26.07.2023 00:00;195406;171600;23806;16.2
20053541;280918;5;27.07.2023 00:00;136698;128700;7998;11.5
20053205;281324;5;28.07.2023 00:00;136442;128700;7742;11.2
20054373;282388;5;14.08.2023 00:00;182504;158980;23524;17.8
20054372;282033;5;15.08.2023 00:00;28332;27650;682;3.6
20054377;284476;5;16.08.2023 00:00;1538;1538;0;0.5
20054370;276099;5;16.08.2023 00:00;72209;57120;15089;6.6
20054369;276087;5;16.08.2023 00:00;151213;137361;13852;13.9
20054366;229758;5;17.08.2023 00:00;166284;149190;17094;14.4
20054364;;5;18.08.2023 00:00;0;0;0;0.0
20054367;271622;5;18.08.2023 00:00;99487;80646;18841;8.3
20054371;276271;5;19.08.2023 00:00;33032;26210;6822;2.8
20054374;283038;5;19.08.2023 00:00;59833;50547;9286;5.3
20054376;283326;5;21.08.2023 00:00;28102;25922;2180;2.7
20054441;277159;5;21.08.2023 00:00;50124;36436;13688;4.2
20054375;283324;5;21.08.2023 00:00;34382;30530;3852;2.9
20054640;285035;5;22.08.2023 00:00;61312;56872;4440;5.8
20054365;;5;22.08.2023 00:00;0;0;0;0.0
20054417;277975;5;22.08.2023 00:00;392078;345842;46236;33.3
20054452;277975;5;24.08.2023 00:00;362660;333174;29486;30.0
20054492;277975;5;26.08.2023 00:00;357732;332642;25090;29.7
20054585;261525;5;29.08.2023 00:00;36887;25808;11079;3.4
20054491;;5;29.08.2023 00:00;0;0;0;0.0
20054838;282257;5;30.08.2023 00:00;29642;25346;4296;3.3
20054835;236161;5;30.08.2023 00:00;21326;16562;4764;1.7
20054839;284983;5;30.08.2023 00:00;14502;10582;3920;1.3
20054837;280443;5;30.08.2023 00:00;7628;7363;265;0.9
20054836;266299;5;30.08.2023 00:00;6871;7362;-491;0.9
20054890;236157;5;30.08.2023 00:00;96670;86482;10188;9.6
20054892;284791;5;31.08.2023 00:00;34056;29834;4222;3.4
20054889;216599;5;31.08.2023 00:00;35079;31946;3133;3.4
20054891;239795;5;31.08.2023 00:00;31896;25345;6551;3.3
20054589;282200;5;01.09.2023 00:00;31022;26139;4883;3.4
20054900;;5;01.09.2023 00:00;0;0;0;0.0
20054963;265650;5;01.09.2023 00:00;66300;55300;11000;7.2
20054962;259466;5;02.09.2023 00:00;56202;45554;10648;4.8
20054964;277330;5;04.09.2023 00:00;56930;43261;13669;4.9
20055046;282548;5;04.09.2023 00:00;39747;33320;6427;3.8
20054961;210333;5;04.09.2023 00:00;28670;25200;3470;3.0
20055045;282157;5;05.09.2023 00:00;30420;26880;3540;3.2
20055076;283386;5;06.09.2023 00:00;31245;20738;10507;2.5
20055153;283385;5;06.09.2023 00:00;29542;25922;3620;2.8
20055151;283383;5;06.09.2023 00:00;78288;73008;5280;7.1
20055152;283384;5;06.09.2023 00:00;40352;36290;4062;4.5
20055077;283387;5;07.09.2023 00:00;53833;51266;2567;5.2
20055073;273056;5;07.09.2023 00:00;29055;25920;3135;2.7
20055148;;5;07.09.2023 00:00;0;0;0;0.0
20055074;273058;5;07.09.2023 00:00;12972;10368;2604;1.0
20055150;228637;5;08.09.2023 00:00;18598;12240;6358;1.7
20055154;284476;5;08.09.2023 00:00;6445;3074;3371;0.4
20055222;276100;5;08.09.2023 00:00;83850;79220;4630;7.4
20055219;222805;5;08.09.2023 00:00;59252;52226;7026;5.8
20055223;282695;5;09.09.2023 00:00;55212;41042;14170;5.1
20055227;285075;5;11.09.2023 00:00;163119;138184;24935;14.1
20055149;;5;11.09.2023 00:00;0;0;0;0.0
20055224;271389;5;12.09.2023 00:00;51630;42240;9390;4.3
20055226;;5;12.09.2023 00:00;0;0;0;0.0
20055335;282667;5;12.09.2023 00:00;32570;25302;7268;2.4
20055225;284873;5;12.09.2023 00:00;32002;25302;6700;2.4
20055408;281416;5;13.09.2023 00:00;227046;211510;15536;19.1
20055336;284234;5;13.09.2023 00:00;28141;25808;2333;2.2
20055456;281410;5;14.09.2023 00:00;56684;50602;6082;4.8
20055513;282670;5;14.09.2023 00:00;89203;82226;6977;7.4
20055457;281410;5;14.09.2023 00:00;47411;42506;4905;4.1
20055511;273162;5;15.09.2023 00:00;25915;26820;-905;2.7
20055509;262838;5;15.09.2023 00:00;31210;27324;3886;2.5
20055512;282160;5;15.09.2023 00:00;33825;25346;8479;2.7
20055599;283323;5;16.09.2023 00:00;12637;10562;2075;1.3
20055598;282543;5;16.09.2023 00:00;67378;58872;8506;6.4
20055596;202155;5;19.09.2023 00:00;39122;34058;5064;2.9
20055823;282200;5;19.09.2023 00:00;56724;47520;9204;4.7
20055595;202131;5;19.09.2023 00:00;21543;19010;2533;2.3
20055597;228104;5;20.09.2023 00:00;132964;113698;19266;13.5
20055817;284152;5;21.09.2023 00:00;27463;22178;5285;2.3
20055818;274476;5;22.09.2023 00:00;32360;29040;3320;3.0
20055816;271104;5;22.09.2023 00:00;253697;243144;10553;24.0
20055960;;5;25.09.2023 00:00;0;0;0;0.0
20055989;285029;5;25.09.2023 00:00;66557;46946;19611;4.7
20055985;283698;5;25.09.2023 00:00;110524;100224;10300;9.5
20055988;284944;5;26.09.2023 00:00;88563;82946;5617;7.7
20055997;285083;5;26.09.2023 00:00;24800;23041;1759;2.4
20056135;284975;5;26.09.2023 00:00;37899;31392;6507;3.5
20056487;285027;5;27.09.2023 00:00;37010;26930;10080;3.1
20055976;202169;5;27.09.2023 00:00;34817;27440;7377;3.1
20055981;276642;5;27.09.2023 00:00;61423;50689;10734;4.8
20055977;202172;5;27.09.2023 00:00;30000;26880;3120;2.7
20055978;226478;5;28.09.2023 00:00;26682;24915;1767;2.8
20056080;277654;5;28.09.2023 00:00;27960;26352;1608;2.8
20056079;207805;5;28.09.2023 00:00;29000;26352;2648;2.7
20056082;283327;5;28.09.2023 00:00;37460;29680;7780;3.0
20056081;282157;5;29.09.2023 00:00;55340;43682;11658;6.1
20056142;282157;5;29.09.2023 00:00;32324;30662;1662;3.5
20056143;282256;5;29.09.2023 00:00;39312;32062;7250;3.6
20056425;282657;5;30.09.2023 00:00;23033;22682;351;2.1
20056248;;5;02.10.2023 00:00;0;0;0;0.0
20056249;273143;5;02.10.2023 00:00;53573;45892;7681;5.2
20056250;282179;5;02.10.2023 00:00;492222;458882;33340;47.3
20056260;281528;5;04.10.2023 00:00;62424;48962;13462;5.1
20056259;276087;5;05.10.2023 00:00;117314;116620;694;11.2
20056533;;5;05.10.2023 00:00;0;0;0;0.0
20056427;285170;5;05.10.2023 00:00;41816;32642;9174;3.6
20056424;;5;06.10.2023 00:00;0;0;0;0.0
20056426;227521;5;06.10.2023 00:00;36442;28002;8440;3.0
20056493;284433;5;06.10.2023 00:00;23848;9217;14631;1.0
20056490;266105;5;06.10.2023 00:00;36868;28002;8866;4.2
20056492;283327;5;07.10.2023 00:00;37502;33602;3900;3.2
20056491;279416;5;09.10.2023 00:00;70354;54577;15777;5.8
20056669;284944;5;09.10.2023 00:00;31328;22754;8574;2.4
20056528;284857;5;10.10.2023 00:00;72023;53714;18309;7.2
20056527;;5;10.10.2023 00:00;0;0;0;0.0
20056532;271389;5;10.10.2023 00:00;68301;57026;11275;6.0
20056550;281791;5;11.10.2023 00:00;32265;26820;5445;2.6
20056549;280137;5;11.10.2023 00:00;31352;26820;4532;2.9
20056594;284410;5;11.10.2023 00:00;38061;28249;9812;3.1
20056593;282113;5;11.10.2023 00:00;57971;51219;6752;4.9
20056592;281113;5;12.10.2023 00:00;55342;47520;7822;5.1
20057123;282206;5;12.10.2023 00:00;29220;25344;3876;2.6
20057122;282201;5;12.10.2023 00:00;29509;25347;4162;2.5
20056666;268858;5;13.10.2023 00:00;22970;17955;5015;2.1
20056667;272018;5;13.10.2023 00:00;125360;110319;15041;12.9
20056841;272016;5;14.10.2023 00:00;63537;57026;6511;6.3
20056668;272020;5;16.10.2023 00:00;142090;132264;9826;14.4
20056840;227487;5;16.10.2023 00:00;51947;46467;5480;4.8
20056859;285047;5;17.10.2023 00:00;77130;67057;10073;6.9
20056842;;5;17.10.2023 00:00;0;0;0;0.0
20056818;285035;5;17.10.2023 00:00;69857;56630;13227;6.5
20057038;285228;5;18.10.2023 00:00;10560;10560;0;8.6
20057377;285652;5;18.10.2023 00:00;10560;10560;0;2.2
20057138;285170;5;18.10.2023 00:00;43461;30914;12547;3.6
20056843;;5;18.10.2023 00:00;0;0;0;0.0
20057135;280133;5;19.10.2023 00:00;55230;48387;6843;5.1
20057137;;5;19.10.2023 00:00;0;0;0;0.0
20057140;283664;5;19.10.2023 00:00;65624;59139;6485;6.7
20057354;259466;5;20.10.2023 00:00;291553;250227;41326;28.3
20057132;;5;20.10.2023 00:00;0;0;0;0.0
20057127;273051;5;06.11.2023 00:00;43517;32834;10683;4.1
20057801;273053;5;06.11.2023 00:00;20307;10370;9937;1.2
20057658;222817;5;06.11.2023 00:00;56845;51242;5603;5.5
20057130;273058;5;06.11.2023 00:00;5452;5186;266;1.0
20057974;282157;5;06.11.2023 00:00;38629;30244;8385;3.2
20058082;282255;5;07.11.2023 00:00;33189;28282;4907;3.0
20057656;202175;5;07.11.2023 00:00;38585;30243;8342;3.1
20057910;284648;5;07.11.2023 00:00;123398;109299;14099;11.7
20057657;202176;5;07.11.2023 00:00;20573;20162;411;2.0
20057909;284123;5;08.11.2023 00:00;30767;26210;4557;3.2
20057912;285651;5;08.11.2023 00:00;19942;15410;4532;1.9
20057911;285374;5;09.11.2023 00:00;35202;31106;4096;3.4
20057905;;5;09.11.2023 00:00;0;0;0;0.0
20058071;285075;5;09.11.2023 00:00;195463;165530;29933;16.4
20057977;285347;5;09.11.2023 00:00;1058;1058;0;0.9
20057975;;5;10.11.2023 00:00;0;0;0;0.0
20057976;271389;5;10.11.2023 00:00;192478;174242;18236;15.8
20057997;281544;5;17.11.2023 00:00;52302;40735;11567;3.9
20057995;261525;5;17.11.2023 00:00;50077;40735;9342;4.2
20058349;283207;5;17.11.2023 00:00;41293;35422;5871;3.5
20058083;267237;5;17.11.2023 00:00;17947;15410;2537;2.1
20057996;281113;5;18.11.2023 00:00;71201;63890;7311;7.1
20058084;268857;5;20.11.2023 00:00;35075;30626;4449;3.5
20058356;268858;5;20.11.2023 00:00;35374;30890;4484;3.6
20058698;285075;5;20.11.2023 00:00;155730;92930;62800;10.2
20058697;;5;20.11.2023 00:00;0;0;0;0.0
20057970;;5;21.11.2023 00:00;0;0;0;0.0
20058201;285599;5;21.11.2023 00:00;962;962;0;0.5
20058198;269474;5;21.11.2023 00:00;75398;64516;10882;7.0
20058199;279525;5;22.11.2023 00:00;37920;27363;10557;3.4
20058714;285946;5;22.11.2023 00:00;42;42;0;0.8
20058712;285945;5;22.11.2023 00:00;40;40;0;2.0
20058200;282694;5;22.11.2023 00:00;35297;25082;10215;3.4
20057969;285724;5;22.11.2023 00:00;2852;2852;0;3.3
20057972;;5;23.11.2023 00:00;0;0;0;0.0
20058580;268720;5;23.11.2023 00:00;32652;27720;4932;3.2
20058581;283657;5;23.11.2023 00:00;62260;50402;11858;6.1
20058582;285783;5;23.11.2023 00:00;1154;1154;0;2.1
20059215;282157;5;06.12.2023 00:00;235474;221902;13573;22.7
20059216;284753;5;07.12.2023 00:00;33410;26743;6667;2.6
20059265;284754;5;07.12.2023 00:00;36744;26138;10606;3.1
20059259;;5;07.12.2023 00:00;0;0;0;0.0
20059264;282206;5;07.12.2023 00:00;31220;25082;6138;3.2
20059262;262477;5;08.12.2023 00:00;35720;26402;9318;3.6
20059261;228104;5;11.12.2023 00:00;123590;107217;16373;11.2
20059289;285606;5;11.12.2023 00:00;92146;82561;9585;8.7
20059260;;5;11.12.2023 00:00;0;0;0;0.0
20059391;285017;5;12.12.2023 00:00;34984;27648;7336;2.7
20059288;276099;5;12.12.2023 00:00;34770;24482;10288;2.7
20059291;276115;5;13.12.2023 00:00;42864;35702;7162;4.9
20059895;282078;5;20.12.2023 00:00;46240;43268;2972;4.0
20059899;282746;5;20.12.2023 00:00;33696;26314;7382;3.0
20059894;281406;5;20.12.2023 00:00;49520;44529;4991;4.3
20059898;282462;5;20.12.2023 00:00;44995;39470;5525;4.1
20059891;215571;5;21.12.2023 00:00;28534;27458;1076;2.8
20059890;215570;5;21.12.2023 00:00;29380;27192;2188;2.8
20059893;271389;5;21.12.2023 00:00;113077;94512;18565;9.0
20059889;212520;5;22.12.2023 00:00;35335;25610;9725;4.6
20059892;236161;5;22.12.2023 00:00;35593;27600;7993;3.0
20059897;282258;5;23.12.2023 00:00;67956;54914;13042;6.3
20059896;282257;5;03.01.2024 00:00;13462;10562;2900;1.5
20060045;286260;5;03.01.2024 00:00;3962;3962;0;2.7
20059925;;5;03.01.2024 00:00;0;0;0;0.0
20059927;286226;5;04.01.2024 00:00;387358;358684;28674;37.6
20059926;286227;5;08.01.2024 00:00;379656;352802;26854;33.2
20059929;286229;5;08.01.2024 00:00;269334;246964;22370;23.6
20059928;286228;5;09.01.2024 00:00;329654;299883;29771;28.2
20060425;286352;5;12.01.2024 00:00;402810;358684;44126;33.4
20060426;286353;5;16.01.2024 00:00;109941;105842;4099;9.7
20060029;228639;5;16.01.2024 00:00;14000;10540;3460;1.3
20060028;228635;5;16.01.2024 00:00;13775;11900;1875;1.5
20060030;228641;5;16.01.2024 00:00;22763;12243;10520;1.5
20060032;271470;5;17.01.2024 00:00;19455;15362;4093;1.7
20060031;228643;5;17.01.2024 00:00;9400;10200;-800;1.3
20060034;271473;5;17.01.2024 00:00;16008;16128;-120;1.8
20060035;281160;5;17.01.2024 00:00;15518;15362;156;1.7
20060033;271472;5;17.01.2024 00:00;16084;15362;722;1.8
20060036;;5;17.01.2024 00:00;0;0;0;0.0
20060253;285892;5;17.01.2024 00:00;21392;10371;11021;1.3
20060125;284645;5;18.01.2024 00:00;24407;20738;3669;2.2
20060126;284648;5;18.01.2024 00:00;141604;125858;15746;12.3
20060252;283698;5;18.01.2024 00:00;271660;231555;40105;24.0
20060123;284116;5;22.01.2024 00:00;32644;24770;7874;2.9
20060124;284377;5;22.01.2024 00:00;23352;15554;7798;1.7
20060127;285913;5;22.01.2024 00:00;19922;15986;3936;1.8
20060121;277159;5;22.01.2024 00:00;34291;24626;9665;3.7
20060211;286271;5;23.01.2024 00:00;4322;4322;0;0.7
20060120;271622;5;23.01.2024 00:00;42149;30963;11186;3.9
20060251;276740;5;23.01.2024 00:00;36461;25585;10876;3.3
20060249;259466;5;24.01.2024 00:00;219876;190322;29554;23.1
20060250;265650;5;26.01.2024 00:00;52123;50402;1721;5.8
20060122;283720;5;26.01.2024 00:00;60978;45092;15886;5.9
20060119;;5;26.01.2024 00:00;0;0;0;0.0
20060453;;5;26.01.2024 00:00;0;0;0;0.0
20060604;282696;5;27.01.2024 00:00;44906;27194;17712;5.2
20060649;266301;5;27.01.2024 00:00;43460;33123;10337;4.0
20060650;268858;5;28.01.2024 00:00;37849;28249;9600;3.0
20060749;285047;5;28.01.2024 00:00;145758;122498;23260;14.5
20061070;285433;5;29.01.2024 00:00;160574;142035;18539;17.1
20060455;285035;5;30.01.2024 00:00;225228;191909;33319;18.3
20060951;;5;30.01.2024 00:00;0;0;0;0.0
20060591;285236;5;01.02.2024 00:00;172495;156818;15677;14.4
20060603;239490;5;01.02.2024 00:00;82179;66794;15385;6.9
20060948;286442;5;02.02.2024 00:00;592598;544324;48274;51.9
20060950;286444;5;05.02.2024 00:00;853699;763564;90135;69.3
20060949;286443;5;09.02.2024 00:00;336192;309960;26232;29.7
20060947;286445;5;10.02.2024 00:00;581911;534240;47671;48.0
20061794;286653;5;13.02.2024 00:00;454832;408242;46590;36.9
20061795;286654;5;15.02.2024 00:00;114555;105842;8713;9.4
20061604;284927;5;16.02.2024 00:00;88329;72767;15562;7.8
20060768;;5;16.02.2024 00:00;0;0;0;0.0
20061566;284628;5;16.02.2024 00:00;12388;11882;506;1.5
20061606;285902;5;16.02.2024 00:00;39732;25347;14385;3.3
20061605;285886;5;17.02.2024 00:00;46880;24336;22544;2.4
20060783;279038;5;17.02.2024 00:00;36504;29683;6821;3.2
20060781;277329;5;18.02.2024 00:00;19413;10083;9330;1.2
20060782;277330;5;18.02.2024 00:00;47662;40040;7622;4.3
20060885;282157;5;18.02.2024 00:00;173605;150500;23105;15.4
20061624;;5;19.02.2024 00:00;0;0;0;0.0
20060884;271225;5;20.02.2024 00:00;33007;28842;4165;3.2
20060883;266105;5;20.02.2024 00:00;70001;28002;41999;4.1
20061859;222805;5;20.02.2024 00:00;60098;52227;7871;5.7
20060652;;5;20.02.2024 00:00;0;0;0;0.0
20061736;276087;5;21.02.2024 00:00;94463;75822;18641;8.3
20061738;281528;5;22.02.2024 00:00;71562;65282;6280;7.0
20061737;276099;5;22.02.2024 00:00;43837;40802;3035;4.2
20061860;267000;5;22.02.2024 00:00;43777;33027;10750;3.2
20061866;282694;5;23.02.2024 00:00;39105;27172;11933;4.0
20061867;282695;5;23.02.2024 00:00;31178;25080;6098;3.5
20061865;279039;5;24.02.2024 00:00;22096;11618;10478;1.4
20061936;;5;24.02.2024 00:00;0;0;0;0.0
20061863;277055;5;24.02.2024 00:00;80783;70524;10259;10.0
20061861;271389;5;24.02.2024 00:00;105102;88707;16395;8.6
20061925;262838;5;25.02.2024 00:00;38969;26316;12653;2.5
20061926;262838;5;25.02.2024 00:00;74542;69832;4710;6.7
20061934;284873;5;26.02.2024 00:00;43907;40735;3172;3.9
20061927;280137;5;26.02.2024 00:00;34436;29856;4580;3.0
20061928;281409;5;26.02.2024 00:00;51408;44530;6878;4.5
20061932;284004;5;26.02.2024 00:00;45000;40986;4014;3.6
20061935;286345;5;27.02.2024 00:00;28878;27327;1551;2.7
20061931;283987;5;27.02.2024 00:00;37766;27324;10442;2.6
20061930;282462;5;27.02.2024 00:00;80444;80201;243;7.5
20061933;284234;5;27.02.2024 00:00;65042;59711;5331;5.7
20061929;281410;5;28.02.2024 00:00;56260;50602;5658;5.1
20062488;272021;5;28.02.2024 00:00;62919;55707;7212;6.1
20062487;272020;5;29.02.2024 00:00;120541;111410;9131;13.2
20062486;272019;5;29.02.2024 00:00;97259;89234;8025;10.5
20062483;272016;5;01.03.2024 00:00;109667;99794;9873;11.6
20062485;272018;5;01.03.2024 00:00;31782;28514;3268;3.2
20062484;272017;5;01.03.2024 00:00;87984;84221;3763;10.1
20062345;;5;02.03.2024 00:00;0;0;0;0.0
20062416;286758;5;02.03.2024 00:00;70404;52274;18130;5.4
20062346;286445;5;02.03.2024 00:00;534000;453602;80398;45.1
20062528;286442;5;05.03.2024 00:00;410886;378002;32884;35.0
20062505;268856;5;07.03.2024 00:00;38676;30360;8316;3.3
20062348;;5;07.03.2024 00:00;0;0;0;0.0
20063008;285821;5;07.03.2024 00:00;3523;3523;0;2.6
20061976;282258;5;08.03.2024 00:00;86525;63892;22633;7.0
20061977;282543;5;08.03.2024 00:00;65442;57028;8414;5.7
20062538;;5;09.03.2024 00:00;0;0;0;0.0
20062602;276087;5;11.03.2024 00:00;35700;32812;2888;3.5
20062601;267000;5;11.03.2024 00:00;34431;27456;6975;2.8
20062677;276100;5;11.03.2024 00:00;71513;57802;13711;6.4
20062600;258872;5;12.03.2024 00:00;29367;27528;1839;2.9
20062603;286755;5;12.03.2024 00:00;3902;3902;0;3.7
20062676;;5;12.03.2024 00:00;0;0;0;0.0
20062790;278011;5;12.03.2024 00:00;28902;24642;4260;3.5
20062791;286850;5;12.03.2024 00:00;13688;6302;7386;1.0
20062800;285907;5;13.03.2024 00:00;20498;15552;4946;1.7
20062797;285890;5;13.03.2024 00:00;32443;20737;11706;3.2
20062794;285083;5;13.03.2024 00:00;38477;21315;17162;3.2
20062799;285900;5;13.03.2024 00:00;12729;10370;2359;1.1
20062798;285893;5;14.03.2024 00:00;16144;13538;2606;1.5
20062792;284648;5;14.03.2024 00:00;153119;141698;11421;14.3
20062796;285684;5;14.03.2024 00:00;16942;15842;1100;1.7
20062793;284795;5;14.03.2024 00:00;12974;10370;2604;1.2
20062795;285651;5;15.03.2024 00:00;30608;25346;5262;2.7
20062802;285914;5;15.03.2024 00:00;30234;25347;4887;2.8
20062801;285908;5;16.03.2024 00:00;21057;14402;6655;1.6
20062928;284837;5;17.03.2024 00:00;142394;129603;12791;12.7
20062930;284975;5;18.03.2024 00:00;23825;20160;3665;1.9
20062933;285912;5;18.03.2024 00:00;18256;15552;2704;2.0
20062929;284857;5;19.03.2024 00:00;39869;36290;3579;3.6
20063128;284975;5;19.03.2024 00:00;39842;37440;2402;3.7
20062926;283660;5;19.03.2024 00:00;38818;25204;13614;3.2
20063129;285605;5;19.03.2024 00:00;12515;10371;2144;1.2
20062983;268663;5;19.03.2024 00:00;29293;22122;7171;2.5
20063024;286686;5;20.03.2024 00:00;22026;20022;2004;2.6
20063026;286688;5;20.03.2024 00:00;15830;10080;5750;1.3
20063022;283566;5;20.03.2024 00:00;25202;15123;10079;4.6
20063025;286687;5;20.03.2024 00:00;21991;20022;1969;2.2
20063023;286395;5;20.03.2024 00:00;69588;64400;5188;6.9
20063082;282157;5;21.03.2024 00:00;489565;450100;39465;45.4
20063185;282157;5;24.03.2024 00:00;115041;100242;14799;10.5
20063186;282255;5;25.03.2024 00:00;30449;28002;2447;3.1
20063184;202172;5;25.03.2024 00:00;24875;20162;4713;2.0
20063215;202176;5;25.03.2024 00:00;24218;20162;4056;1.9
20063216;277330;5;25.03.2024 00:00;44919;40322;4597;3.9
20063217;281384;5;26.03.2024 00:00;8845;10082;-1237;1.2
20063536;283038;5;26.03.2024 00:00;35251;25346;9905;2.9
20063535;279416;5;26.03.2024 00:00;27143;25344;1799;2.6
20063537;283973;5;26.03.2024 00:00;14683;11522;3161;1.1
20063391;286857;5;27.03.2024 00:00;521041;432720;88321;44.5
20063470;286487;5;03.04.2024 00:00;144300;128306;15994;12.0
20063680;284049;5;04.04.2024 00:00;210724;181442;29282;17.3
20063726;284485;5;05.04.2024 00:00;106488;92736;13752;8.9
20063725;284264;5;05.04.2024 00:00;59058;48386;10672;4.8
20063724;284051;5;06.04.2024 00:00;34249;24192;10057;2.0
20063804;279156;5;08.04.2024 00:00;48297;40322;7975;3.9
20063723;272565;5;08.04.2024 00:00;48999;44210;4789;4.4
20063728;286915;5;08.04.2024 00:00;84611;72576;12035;6.8
20063727;285653;5;09.04.2024 00:00;24304;24192;112;2.2
20063802;279019;5;09.04.2024 00:00;25878;16704;9174;1.8
20064172;284050;5;09.04.2024 00:00;53681;44357;9324;4.5
20063803;279144;5;10.04.2024 00:00;84161;65664;18497;6.9
20063722;270339;5;10.04.2024 00:00;39485;31104;8381;3.2
20063858;270324;5;11.04.2024 00:00;15714;11520;4194;1.3
20063721;284927;5;11.04.2024 00:00;116896;102062;14834;10.6
20064486;;5;12.04.2024 00:00;0;0;0;0.0
20063130;268681;5;12.04.2024 00:00;32638;28224;4414;3.1
20064177;285887;5;12.04.2024 00:00;26862;14403;12459;2.2
20064176;283698;5;12.04.2024 00:00;94442;85827;8615;9.0
20064163;259466;5;15.04.2024 00:00;395269;356619;38650;37.0
20064164;265650;5;17.04.2024 00:00;61182;57403;3779;5.8
20063959;;5;17.04.2024 00:00;0;0;0;0.0
20064173;286400;5;18.04.2024 00:00;135030;105600;29430;10.9
20064162;;5;18.04.2024 00:00;0;0;0;0.0
20064175;287034;5;19.04.2024 00:00;11677;11677;0;5.2
20064169;279475;5;19.04.2024 00:00;34202;25082;9120;3.2
20064223;287143;5;19.04.2024 00:00;11320;11320;0;4.1
20064171;283664;5;19.04.2024 00:00;53149;50690;2459;5.6
20064170;280133;5;20.04.2024 00:00;56602;48386;8216;5.5
20064167;276088;5;20.04.2024 00:00;13392;10203;3189;1.3
20064166;273545;5;22.04.2024 00:00;34007;30722;3285;3.5
20064168;276100;5;22.04.2024 00:00;35448;30600;4848;3.0
20064174;286884;5;22.04.2024 00:00;31934;32450;-516;4.1
20064165;273143;5;22.04.2024 00:00;99345;92618;6727;8.8
20064399;282179;5;23.04.2024 00:00;326372;313346;13026;31.1
20063961;;5;25.04.2024 00:00;0;0;0;0.0
20064583;282200;5;25.04.2024 00:00;56854;48048;8806;5.2
20064581;283987;5;25.04.2024 00:00;51721;40733;10988;4.2
20064648;282462;5;26.04.2024 00:00;83730;79950;3780;7.6
20064649;282667;5;26.04.2024 00:00;59442;55662;3780;5.1
20064647;282078;5;26.04.2024 00:00;31092;27326;3766;2.7
20064650;287075;5;26.04.2024 00:00;27942;25302;2640;2.7
20064651;236415;5;27.04.2024 00:00;30984;15645;15339;1.8
20064694;236414;5;29.04.2024 00:00;25265;22083;3182;2.2
20064695;266301;5;29.04.2024 00:00;33002;31742;1260;3.5
20064927;287023;5;29.04.2024 00:00;1785;1785;0;2.6
20064696;282206;5;29.04.2024 00:00;26007;20067;5940;2.3
20064736;282257;5;29.04.2024 00:00;36086;31680;4406;3.7
20064734;268858;5;30.04.2024 00:00;37330;31682;5648;3.5
20064180;;5;30.04.2024 00:00;0;0;0;0.0
20064938;284644;5;30.04.2024 00:00;20898;10370;10528;1.7
20064928;284645;5;30.04.2024 00:00;26005;24194;1811;2.5
20064926;285774;5;30.04.2024 00:00;16461;12098;4363;1.4
20064925;284831;5;30.04.2024 00:00;13092;10370;2722;1.3
20064932;285907;5;01.05.2024 00:00;13556;10368;3188;1.0
20064931;285680;5;01.05.2024 00:00;17115;16418;697;1.7
20064930;285605;5;01.05.2024 00:00;32080;25922;6158;3.1
20064929;284837;5;01.05.2024 00:00;55349;51552;3797;5.5
20064924;283327;5;02.05.2024 00:00;42148;39202;2946;4.2
20064923;282657;5;02.05.2024 00:00;31580;23522;8058;2.8
20065054;282157;5;02.05.2024 00:00;283586;262080;21506;25.6
20065093;283384;5;03.05.2024 00:00;55328;46658;8670;5.1
20065094;287155;5;06.05.2024 00:00;2147;1010;1137;0.2
20065092;273055;5;06.05.2024 00:00;27378;10226;17152;1.4
20064939;;5;06.05.2024 00:00;0;0;0;0.0
20065283;286982;5;06.05.2024 00:00;396635;332643;63992;34.1
20065411;286982;5;08.05.2024 00:00;372295;332642;39653;32.5
20065495;286982;5;13.05.2024 00:00;368806;332642;36164;31.9
20065544;;5;15.05.2024 00:00;0;0;0;0.0
20065121;285433;5;15.05.2024 00:00;338480;291194;47286;29.6
20065688;282206;5;17.05.2024 00:00;34880;25344;9536;2.9
20065687;236158;5;17.05.2024 00:00;36312;29442;6870;3.3
20065608;216599;5;17.05.2024 00:00;43706;35906;7800;3.5
20065609;265001;5;18.05.2024 00:00;33029;27458;5571;3.0
20065611;283331;5;18.05.2024 00:00;90736;72867;17869;7.8
20065686;215571;5;21.05.2024 00:00;37915;31685;6230;3.0
20065610;281503;5;21.05.2024 00:00;27387;25302;2085;2.7
20065758;215570;5;21.05.2024 00:00;29967;26400;3567;2.7
20065759;282696;5;22.05.2024 00:00;35097;25082;10015;3.7
20065760;;5;22.05.2024 00:00;0;0;0;0.0
20065763;284543;5;22.05.2024 00:00;33640;26603;7037;3.2
20065762;271622;5;22.05.2024 00:00;106002;94178;11824;9.5
20065879;285027;5;23.05.2024 00:00;20239;11520;8719;1.7
20065880;285914;5;25.05.2024 00:00;18591;10800;7791;1.3
20065905;284123;5;25.05.2024 00:00;27277;27650;-373;3.5
20065907;287470;5;27.05.2024 00:00;4502;4502;0;3.8
20065906;287469;5;27.05.2024 00:00;4416;4416;0;2.5
20065904;276740;5;27.05.2024 00:00;57900;52418;5482;8.1
20065965;276087;5;28.05.2024 00:00;76373;66982;9391;8.1
20065761;;5;28.05.2024 00:00;0;0;0;0.0
20065940;228635;5;28.05.2024 00:00;22692;14280;8412;2.5
20065941;228645;5;28.05.2024 00:00;15044;12072;2972;1.3
20065943;286925;5;29.05.2024 00:00;16989;10882;6107;1.2
20065942;273143;5;29.05.2024 00:00;110527;101376;9151;10.8
20065966;276099;5;29.05.2024 00:00;20202;16322;3880;2.0
20065968;;5;30.05.2024 00:00;0;0;0;0.0
20066630;287143;5;30.05.2024 00:00;9470;9470;0;3.6
20066326;287283;5;30.05.2024 00:00;19716;14564;5152;1.8
20066100;286395;5;30.05.2024 00:00;41939;32482;9457;3.3
20066096;282255;5;30.05.2024 00:00;32587;30800;1787;3.3
20066095;222817;5;31.05.2024 00:00;59928;50402;9526;5.3
20066099;283388;5;31.05.2024 00:00;17380;10368;7012;1.2
20066098;283386;5;31.05.2024 00:00;18723;14834;3889;2.1
20066104;277329;5;31.05.2024 00:00;32719;20165;12554;2.3
20066097;283385;5;31.05.2024 00:00;37226;31106;6120;3.6
20066103;202175;5;03.06.2024 00:00;23502;21002;2500;2.1
20066845;287965;5;07.06.2024 00:00;32502;32502;0;2.5
20066624;275509;5;10.06.2024 00:00;0;0;0;3.4
20066205;281506;5;10.06.2024 00:00;22902;20162;2740;2.1
20066206;287341;5;10.06.2024 00:00;24003;20163;3840;2.5
20066102;202169;5;10.06.2024 00:00;27042;21842;5200;2.5
20066207;284645;5;11.06.2024 00:00;29752;25634;4118;2.5
20066208;284648;5;11.06.2024 00:00;105102;98210;6892;10.0
20066510;285635;5;12.06.2024 00:00;24475;20738;3737;2.2
20066789;284795;5;12.06.2024 00:00;26802;20739;6063;2.2
20066211;285907;5;12.06.2024 00:00;43368;36290;7078;3.8
20066209;284836;5;13.06.2024 00:00;14166;10370;3796;1.1
20066210;285680;5;13.06.2024 00:00;37342;33410;3932;3.4
20066511;285890;5;14.06.2024 00:00;14756;10371;4385;1.0
20066219;279416;5;14.06.2024 00:00;67572;50690;16882;5.7
20066220;283038;5;19.06.2024 00:00;73908;64514;9394;7.2
20067052;283566;5;20.06.2024 00:00;36442;26743;9699;1.5
20067051;265650;5;20.06.2024 00:00;59125;51100;8025;5.8
20066401;;5;20.06.2024 00:00;0;0;0;0.0
20067060;281528;5;21.06.2024 00:00;57802;40802;17000;4.1
20067059;222805;5;21.06.2024 00:00;59758;52224;7534;5.8
20067061;;5;21.06.2024 00:00;0;0;0;0.0
20067131;285047;5;22.06.2024 00:00;64463;59139;5324;6.3
20067188;283328;5;22.06.2024 00:00;62345;54912;7433;6.3
20067256;277058;5;22.06.2024 00:00;24005;16633;7372;2.6
20067255;277055;5;23.06.2024 00:00;116362;92928;23434;13.2
20067323;284234;5;23.06.2024 00:00;83326;64773;18553;6.8
20067322;202158;5;24.06.2024 00:00;62509;55180;7329;5.3
20067358;281113;5;25.06.2024 00:00;47171;40132;7039;4.7
20067359;282543;5;25.06.2024 00:00;58079;54917;3162;5.6
20067478;272021;5;26.06.2024 00:00;260223;234168;26055;25.9
20067645;272019;5;27.06.2024 00:00;142142;132266;9876;15.0
20067644;272017;5;28.06.2024 00:00;210702;193514;17188;21.5
20067739;272020;5;29.06.2024 00:00;245261;211205;34056;23.7
20067854;272018;5;01.07.2024 00:00;267459;247898;19561;27.4
20068149;272016;5;02.07.2024 00:00;116087;99002;17085;11.6
20067870;270071;5;03.07.2024 00:00;353668;318386;35282;36.4
20067807;;5;07.07.2024 00:00;0;0;0;0.0
20067808;277159;5;07.07.2024 00:00;70706;30528;40178;4.5
20067809;280635;5;07.07.2024 00:00;13700;10944;2756;1.6
20068012;287496;5;08.07.2024 00:00;5502;4062;1440;0.5
20068013;287499;5;08.07.2024 00:00;5502;4062;1440;0.4
20068711;259466;5;22.07.2024 00:00;205150;174099;31051;18.4
20068719;287916;5;23.07.2024 00:00;9069;5042;4027;0.7
20068018;285896;5;23.07.2024 00:00;85244;74022;11222;7.3
20068184;283698;5;23.07.2024 00:00;223581;207218;16363;19.7
20068017;285890;5;24.07.2024 00:00;71447;61779;9668;6.8
20068713;285774;5;25.07.2024 00:00;21654;20596;1058;2.3
20068016;285887;5;25.07.2024 00:00;12904;10370;2534;1.5
20068015;285027;5;25.07.2024 00:00;34370;25347;9023;2.8
20068721;284975;5;25.07.2024 00:00;32402;25058;7344;2.8
20068722;285914;5;26.07.2024 00:00;11864;10370;1494;1.3
20068718;287499;5;26.07.2024 00:00;8939;5042;3897;0.7
20068019;285914;5;26.07.2024 00:00;18757;18434;323;2.1
20068720;;5;26.07.2024 00:00;0;0;0;0.0
20068712;283657;5;26.07.2024 00:00;36733;30242;6491;3.2
20068806;272016;5;27.07.2024 00:00;118064;99794;18270;11.0
20068827;282698;5;29.07.2024 00:00;36882;26666;10216;3.6
20069190;288525;5;29.07.2024 00:00;7862;7862;0;1.9
20068829;287495;5;30.07.2024 00:00;9267;5018;4249;0.7
20068916;281791;5;30.07.2024 00:00;41239;26315;14924;3.2
20068914;281409;5;30.07.2024 00:00;30448;26314;4134;2.6
20068917;282462;5;30.07.2024 00:00;51482;44530;6952;4.3
20068915;281544;5;30.07.2024 00:00;46951;41492;5459;4.1
20068918;283207;5;31.07.2024 00:00;29882;26315;3567;2.7
20069023;280137;5;31.07.2024 00:00;47306;40480;6826;4.1
20069027;284873;5;31.07.2024 00:00;28400;22267;6133;2.2
20069026;282670;5;02.08.2024 00:00;86029;79697;6332;7.7
20069025;281416;5;02.08.2024 00:00;113467;101455;12012;10.1
20069024;281406;5;03.08.2024 00:00;93808;81976;11832;7.9
20069114;287075;5;05.08.2024 00:00;37024;27324;9700;3.0
20069112;283987;5;05.08.2024 00:00;28778;27324;1454;2.4
20069116;288192;5;05.08.2024 00:00;15365;12146;3219;1.3
20069115;288190;5;05.08.2024 00:00;11819;11090;729;1.2
20069113;285433;5;05.08.2024 00:00;45163;29043;16120;3.2
20069028;288152;5;06.08.2024 00:00;20989;20989;0;6.8
20069029;;5;06.08.2024 00:00;0;0;0;0.0
20069030;;5;06.08.2024 00:00;0;0;0;0.0
20069351;287729;5;06.08.2024 00:00;99112;87554;11558;9.0
20069438;228637;5;07.08.2024 00:00;22233;14791;7442;2.4
20069441;278624;5;07.08.2024 00:00;13189;10542;2647;1.1
20069440;228645;5;07.08.2024 00:00;14931;13602;1329;1.8
20069437;228635;5;07.08.2024 00:00;17553;13602;3951;1.6
20069439;228642;5;08.08.2024 00:00;13002;9692;3310;1.0
20069352;288163;5;08.08.2024 00:00;63048;55108;7940;5.8
20069350;283664;5;08.08.2024 00:00;52395;48386;4009;5.0
20069348;282694;5;09.08.2024 00:00;81422;58332;23090;8.0
20069349;282695;5;09.08.2024 00:00;33582;30022;3560;4.1
20069117;;5;10.08.2024 00:00;0;0;0;0.0
20069354;284628;5;10.08.2024 00:00;21402;12422;8980;1.3
20069356;284927;5;12.08.2024 00:00;167784;151742;16042;15.9
20069355;284927;5;13.08.2024 00:00;109010;105707;3303;11.3
20069675;;5;13.08.2024 00:00;0;0;0;0.0
20069445;277159;5;13.08.2024 00:00;23388;20160;3228;2.4
20069444;276642;5;13.08.2024 00:00;30400;25345;5055;2.5
20069446;277654;5;14.08.2024 00:00;15583;12098;3485;1.6
20069448;288483;5;14.08.2024 00:00;17868;15842;2026;1.7
20069447;287079;5;14.08.2024 00:00;77877;66240;11637;6.9
20069460;287499;5;15.08.2024 00:00;5851;5043;808;1.0
20069453;285027;5;15.08.2024 00:00;40102;20738;19364;3.2
20069449;284123;5;15.08.2024 00:00;40710;34560;6150;4.3
20069450;284648;5;16.08.2024 00:00;187944;167619;20325;15.8
20069454;285890;5;17.08.2024 00:00;54038;42770;11268;4.4
20069451;284837;5;19.08.2024 00:00;126929;115203;11726;11.8
20069455;285912;5;20.08.2024 00:00;13302;10370;2932;1.0
20069452;284975;5;20.08.2024 00:00;17347;15844;1503;1.7
20069932;;5;20.08.2024 00:00;0;0;0;0.0
20069935;278213;5;20.08.2024 00:00;35327;26400;8927;3.1
20069936;281113;5;21.08.2024 00:00;79601;60194;19407;7.3
20069937;283323;5;21.08.2024 00:00;11669;10562;1107;1.1
20069933;272017;5;21.08.2024 00:00;167649;153122;14527;16.4
20069934;276014;5;22.08.2024 00:00;48283;41253;7030;4.4
20069938;272016;5;23.08.2024 00:00;185116;162364;22752;17.4
20069939;272019;5;26.08.2024 00:00;228259;215954;12305;22.3
20070165;276013;5;27.08.2024 00:00;46035;42240;3795;4.2
20070183;288615;5;27.08.2024 00:00;4187;3922;265;0.9
20070177;;5;27.08.2024 00:00;0;0;0;0.0
20070179;282657;5;27.08.2024 00:00;42256;26882;15374;3.4
20070181;283566;5;28.08.2024 00:00;27034;25202;1832;2.6
20070182;286395;5;28.08.2024 00:00;28965;26322;2643;2.9
20070180;283325;5;28.08.2024 00:00;41655;25347;16308;3.4
20070178;210333;5;28.08.2024 00:00;13979;10082;3897;1.7
20070186;284377;5;29.08.2024 00:00;27648;20739;6909;2.2
20070188;285902;5;29.08.2024 00:00;47233;38021;9212;4.0
20070189;287598;5;30.08.2024 00:00;76672;70851;5821;7.4
20070187;285886;5;30.08.2024 00:00;22002;20738;1264;2.2
20070185;287596;5;31.08.2024 00:00;289141;273891;15250;27.9
20070305;272021;5;03.09.2024 00:00;163306;143618;19688;15.5
20070190;;5;03.09.2024 00:00;0;0;0;0.0
20070304;272020;5;05.09.2024 00:00;302165;275885;26280;28.2
20070377;272018;5;06.09.2024 00:00;238107;221765;16342;23.5
20070403;270071;5;09.09.2024 00:00;22050;16898;5152;1.9
20070420;282746;5;09.09.2024 00:00;33203;26820;6383;2.5
20070404;;5;10.09.2024 00:00;0;0;0;0.0
20070702;;5;10.09.2024 00:00;0;0;0;0.0
20070405;286180;5;10.09.2024 00:00;26441;13022;13419;1.5
20070931;288259;5;10.09.2024 00:00;82303;52560;29743;4.4
20070712;287601;5;11.09.2024 00:00;74768;48384;26384;6.1
20070930;284051;5;11.09.2024 00:00;29508;23906;5602;2.3
20070709;286487;5;12.09.2024 00:00;196428;177410;19018;17.5
20070710;286857;5;13.09.2024 00:00;149552;129026;20526;12.8
20070707;279156;5;16.09.2024 00:00;158725;147170;11555;14.5
20070711;286915;5;16.09.2024 00:00;120911;105986;14925;10.2
20070705;272565;5;17.09.2024 00:00;107640;92738;14902;9.2
20070708;284050;5;18.09.2024 00:00;117741;100800;16941;10.1
20070706;279019;5;19.09.2024 00:00;146646;129026;17620;12.3
20070713;288098;5;20.09.2024 00:00;32868;28224;4644;3.0
20070929;279144;5;20.09.2024 00:00;165515;125570;39945;13.1
20070704;;5;22.09.2024 00:00;0;0;0;0.0
20070714;288738;5;22.09.2024 00:00;110110;80498;29612;8.7
20070715;279416;5;23.09.2024 00:00;96531;82370;14161;8.7
20070755;283038;5;23.09.2024 00:00;85523;75457;10066;7.8
20070850;271622;5;24.09.2024 00:00;67402;59330;8072;5.9
20070857;285900;5;24.09.2024 00:00;16377;10371;6006;1.3
20070853;284645;5;24.09.2024 00:00;44261;38018;6243;4.0
20070854;285635;5;25.09.2024 00:00;10683;10368;315;1.2
20070856;285774;5;25.09.2024 00:00;21085;20738;347;2.2
20070858;285906;5;25.09.2024 00:00;11954;10368;1586;1.3
20070855;285680;5;25.09.2024 00:00;12746;10368;2378;1.1
20070852;283698;5;25.09.2024 00:00;60869;58608;2261;5.4
20070703;;5;26.09.2024 00:00;0;0;0;0.0
20071264;282462;5;26.09.2024 00:00;99752;89056;10696;8.9
20071308;282258;5;27.09.2024 00:00;145850;132002;13848;13.4
20071306;281113;5;27.09.2024 00:00;62233;58081;4152;5.8
20071430;282543;5;28.09.2024 00:00;64607;57024;7583;5.8
20071429;282206;5;30.09.2024 00:00;53787;49632;4155;5.0
20071426;212520;5;30.09.2024 00:00;37158;29835;7323;3.7
20071428;277055;5;01.10.2024 00:00;80558;76298;4260;9.4
20071353;282400;5;01.10.2024 00:00;18231;10563;7668;1.2
20071354;288311;5;01.10.2024 00:00;19926;17954;1972;2.1
20071352;282200;5;01.10.2024 00:00;33247;31418;1829;3.2
20070939;288778;5;02.10.2024 00:00;6379;6379;0;1.7
20071504;289022;5;02.10.2024 00:00;8270;8270;0;5.8
20071427;274476;5;02.10.2024 00:00;48657;27459;21198;2.8
20071431;;5;02.10.2024 00:00;0;0;0;0.0
20071502;284123;5;03.10.2024 00:00;50722;33985;16737;4.3
20071503;285683;5;03.10.2024 00:00;14258;12046;2212;1.2
20071725;283698;5;04.10.2024 00:00;25561;20738;4823;2.2
20071499;282549;5;04.10.2024 00:00;26885;20161;6724;2.1
20071498;282159;5;04.10.2024 00:00;24310;20162;4148;2.2
20071500;282657;5;05.10.2024 00:00;25474;20160;5314;2.0
20071501;283383;5;07.10.2024 00:00;78538;63362;15176;6.9
20071730;253336;5;12.10.2024 00:00;37559;26881;10678;3.1
20071495;;5;12.10.2024 00:00;0;0;0;0.0
20071731;282389;5;12.10.2024 00:00;129637;107329;22308;11.6
20071732;287729;5;13.10.2024 00:00;62277;50688;11589;5.3
20071757;288753;5;14.10.2024 00:00;565;565;0;2.8
20071733;288821;5;14.10.2024 00:00;21354;12922;8432;1.6
20071496;;5;14.10.2024 00:00;0;0;0;0.0
20071739;288818;5;14.10.2024 00:00;16502;12146;4356;1.2
20071740;288894;5;15.10.2024 00:00;30142;25344;4798;2.6
20071753;284754;5;15.10.2024 00:00;11835;5813;6022;0.8
20071754;;5;15.10.2024 00:00;0;0;0;0.0
20072278;283387;5;15.10.2024 00:00;36603;31107;5496;3.0
20071726;227521;5;16.10.2024 00:00;33378;31640;1738;3.4
20071756;284753;5;16.10.2024 00:00;30890;24642;6248;2.5
20072280;285913;5;16.10.2024 00:00;19588;10369;9219;1.3
20072414;284857;5;17.10.2024 00:00;10937;10659;278;1.0
20072279;285029;5;17.10.2024 00:00;23923;16707;7216;1.5
20072281;285914;5;17.10.2024 00:00;28299;23042;5257;2.5
20072707;285433;5;04.11.2024 00:00;50882;43826;7056;5.2
20072669;285047;5;04.11.2024 00:00;44865;34850;10015;3.4
20072671;285047;5;04.11.2024 00:00;81792;74978;6814;7.4
20072670;285047;5;05.11.2024 00:00;54427;50690;3737;5.5
20072661;289077;5;05.11.2024 00:00;16835;10562;6273;1.1
20072657;282258;5;05.11.2024 00:00;67672;60192;7480;6.0
20072656;281728;5;06.11.2024 00:00;20806;17955;2851;1.8
20072655;267237;5;06.11.2024 00:00;35122;25762;9360;2.6
20073092;283331;5;06.11.2024 00:00;25184;20242;4942;2.0
20073090;281544;5;07.11.2024 00:00;75802;65782;10020;6.5
20073091;282667;5;07.11.2024 00:00;28500;26312;2188;2.4
20072653;;5;08.11.2024 00:00;0;0;0;0.0
20072915;283664;5;08.11.2024 00:00;88202;76034;12168;7.9
20072914;282179;5;08.11.2024 00:00;351101;324866;26235;32.5
20073087;282389;5;12.11.2024 00:00;119700;110016;9684;11.5
20042202;282454;6;03.01.2023 00:00;7700;3520;4180;0.4
20042197;275567;6;03.01.2023 00:00;41400;29568;11832;3.4
20042198;278066;6;03.01.2023 00:00;57000;43648;13352;5.2
20042634;281467;6;03.01.2023 00:00;325588;272020;53568;31.5
20042816;253641;6;06.01.2023 00:00;110103;83075;27028;11.0
20042805;281822;6;06.01.2023 00:00;31350;26208;5142;3.1
20042643;277007;6;07.01.2023 00:00;35810;26911;8899;3.0
20042859;274923;6;07.01.2023 00:00;59982;53822;6160;6.2
20042707;;6;07.01.2023 00:00;0;0;0;0.0
20042919;273260;6;08.01.2023 00:00;50102;44507;5595;5.7
20042807;274759;6;08.01.2023 00:00;262252;225422;36830;29.5
20043132;281652;6;10.01.2023 00:00;26400;21060;5340;2.6
20043134;282196;6;10.01.2023 00:00;13500;10920;2580;1.8
20043119;260728;6;10.01.2023 00:00;28400;20280;8120;2.8
20043135;282197;6;10.01.2023 00:00;14800;10140;4660;1.3
20043216;280716;6;10.01.2023 00:00;28000;20280;7720;2.7
20043218;281830;6;11.01.2023 00:00;13685;10140;3545;1.6
20043217;281726;6;11.01.2023 00:00;23658;18720;4938;2.5
20043123;275231;6;11.01.2023 00:00;25152;21060;4092;3.3
20043219;281831;6;11.01.2023 00:00;120610;98280;22330;14.5
20043214;266786;6;11.01.2023 00:00;12500;10920;1580;1.5
20043129;279702;6;12.01.2023 00:00;45400;40560;4840;5.4
20043221;279880;6;12.01.2023 00:00;12500;10140;2360;1.4
20043127;275589;6;12.01.2023 00:00;13502;10923;2579;1.5
20043215;277234;6;12.01.2023 00:00;13500;10920;2580;1.5
20043220;281926;6;13.01.2023 00:00;109800;101400;8400;13.8
20043213;255612;6;13.01.2023 00:00;39500;35881;3619;5.0
20043222;282401;6;13.01.2023 00:00;11800;10920;880;1.5
20043117;257197;6;14.01.2023 00:00;31100;25813;5287;3.0
20043120;265995;6;14.01.2023 00:00;30670;26747;3923;3.0
20042916;229876;6;14.01.2023 00:00;62930;56160;6770;6.7
20043136;282464;6;15.01.2023 00:00;57102;50066;7036;5.7
20043130;280134;6;15.01.2023 00:00;60608;50065;10543;5.6
20043128;275729;6;15.01.2023 00:00;54500;50065;4435;5.8
20043122;272283;6;16.01.2023 00:00;30502;26522;3980;3.0
20043121;271775;6;16.01.2023 00:00;23700;18480;5220;2.2
20043118;257773;6;16.01.2023 00:00;44500;40320;4180;4.7
20043277;278664;6;17.01.2023 00:00;31287;25197;6090;3.5
20042918;257787;6;17.01.2023 00:00;56000;50388;5612;6.9
20043276;277469;6;17.01.2023 00:00;323500;300067;23433;40.2
20043125;275547;6;19.01.2023 00:00;29800;26520;3280;3.1
20043126;275548;6;20.01.2023 00:00;38000;34320;3680;3.9
20043124;275545;6;20.01.2023 00:00;12800;10920;1880;1.2
20043131;280637;6;20.01.2023 00:00;121600;102960;18640;12.1
20043114;;6;21.01.2023 00:00;0;0;0;0.0
20043446;267786;6;21.01.2023 00:00;52000;40600;11400;4.8
20042706;270508;6;22.01.2023 00:00;114302;103842;10460;12.2
20043445;254933;6;22.01.2023 00:00;40850;27840;13010;3.7
20043448;282680;6;22.01.2023 00:00;5202;2718;2484;0.3
20042709;281792;6;23.01.2023 00:00;1302;1556;-254;3.9
20042200;281793;6;23.01.2023 00:00;2;1555;-1553;1.0
20043678;274895;6;23.01.2023 00:00;20000;14432;5568;1.7
20043679;275113;6;23.01.2023 00:00;20003;14787;5216;1.8
20043663;278066;6;24.01.2023 00:00;48710;46464;2246;5.3
20043574;272030;6;24.01.2023 00:00;141790;122848;18942;14.2
20043801;;6;25.01.2023 00:00;0;0;0;0.0
20043677;271530;6;25.01.2023 00:00;18130;15671;2459;1.8
20043867;280400;6;25.01.2023 00:00;687100;602952;84148;70.8
20043902;271516;6;29.01.2023 00:00;567800;502460;65340;58.9
20044033;280942;6;01.02.2023 00:00;122700;107250;15450;12.4
20043800;;6;01.02.2023 00:00;0;0;0;0.0
20044035;282864;6;02.02.2023 00:00;640762;600602;40160;69.1
20044523;279506;6;05.02.2023 00:00;461400;429000;32400;49.9
20044615;283165;6;08.02.2023 00:00;66060;64350;1710;7.7
20044657;283173;6;08.02.2023 00:00;70068;64352;5716;7.5
20044616;283166;6;08.02.2023 00:00;91494;85800;5694;9.6
20044656;283167;6;09.02.2023 00:00;138058;128702;9356;15.8
20044642;282097;6;10.02.2023 00:00;780;780;0;6.7
20044417;281411;6;10.02.2023 00:00;57271;50064;7207;5.8
20044478;282463;6;10.02.2023 00:00;55052;50066;4986;5.7
20044025;281502;6;11.02.2023 00:00;57542;50736;6806;6.9
20044638;278331;6;11.02.2023 00:00;155949;148514;7435;17.3
20044026;281799;6;12.02.2023 00:00;17500;15210;2290;1.8
20044515;;6;12.02.2023 00:00;0;0;0;0.0
20044917;209946;6;13.02.2023 00:00;53607;42099;11508;4.9
20044788;275509;6;13.02.2023 00:00;1;1;0;5.8
20044916;209945;6;13.02.2023 00:00;42756;40063;2693;4.6
20044923;281687;6;14.02.2023 00:00;33000;27300;5700;3.2
20044757;274162;6;14.02.2023 00:00;23502;17656;5846;2.1
20044918;234666;6;14.02.2023 00:00;120120;103194;16926;11.7
20044872;281853;6;15.02.2023 00:00;43300;25344;17956;3.1
20044925;283209;6;15.02.2023 00:00;33652;28420;5232;3.4
20044922;279704;6;15.02.2023 00:00;26006;25520;486;3.2
20044921;276109;6;16.02.2023 00:00;116792;97442;19350;11.3
20044751;;6;17.02.2023 00:00;0;0;0;0.0
20045069;283334;6;17.02.2023 00:00;2;2;0;0.0
20044416;215474;6;17.02.2023 00:00;22500;15794;6706;2.0
20044476;210811;6;17.02.2023 00:00;35602;33590;2012;4.2
20045166;275191;6;18.02.2023 00:00;63002;54602;8400;6.3
20045021;276841;6;18.02.2023 00:00;28300;25194;3106;3.3
20045165;275189;6;18.02.2023 00:00;35002;35882;-880;4.2
20045022;283084;6;18.02.2023 00:00;56298;50068;6230;7.4
20045587;273260;6;19.02.2023 00:00;95402;77625;17777;10.8
20044963;249580;6;19.02.2023 00:00;42750;25741;17009;3.0
20044964;276580;6;20.02.2023 00:00;84852;70982;13870;8.4
20045063;282029;6;20.02.2023 00:00;12540;10920;1620;1.3
20045062;270707;6;21.02.2023 00:00;28160;19656;8504;2.2
20045060;270700;6;21.02.2023 00:00;14300;10192;4108;1.2
20045061;270704;6;21.02.2023 00:00;24000;21112;2888;2.4
20045599;276118;6;21.02.2023 00:00;153500;138040;15460;15.9
20045588;;6;21.02.2023 00:00;0;0;0;0.0
20045597;276116;6;22.02.2023 00:00;103800;95700;8100;11.1
20045623;266011;6;23.02.2023 00:00;59000;53820;5180;6.4
20045646;271129;6;23.02.2023 00:00;146500;136620;9880;15.8
20045717;279563;6;24.02.2023 00:00;198500;186912;11588;21.6
20045593;270508;6;25.02.2023 00:00;90200;73337;16863;8.7
20045827;281467;6;26.02.2023 00:00;325500;296960;28540;34.1
20045829;282853;6;27.02.2023 00:00;43502;41762;1740;4.8
20045826;234666;6;28.02.2023 00:00;33800;27573;6227;3.3
20045830;282971;6;28.02.2023 00:00;157000;145996;11004;16.9
20045832;283441;6;01.03.2023 00:00;2000;1947;53;0.3
20045831;272030;6;01.03.2023 00:00;127402;117922;9480;13.7
20045715;272458;6;02.03.2023 00:00;112300;105924;6376;11.3
20045716;273125;6;03.03.2023 00:00;29600;26481;3119;3.2
20045833;;6;03.03.2023 00:00;0;0;0;0.0
20046117;;6;03.03.2023 00:00;0;0;0;0.0
20046273;280731;6;03.03.2023 00:00;30750;15600;15150;1.8
20045844;281112;6;04.03.2023 00:00;55853;46803;9050;6.6
20046223;273267;6;04.03.2023 00:00;85600;71070;14530;9.7
20046036;273267;6;05.03.2023 00:00;80602;77972;2630;10.2
20045862;281378;6;05.03.2023 00:00;115900;100800;15100;11.8
20045997;281411;6;06.03.2023 00:00;59000;50064;8936;6.5
20045996;281405;6;07.03.2023 00:00;56982;50066;6916;5.6
20045998;282846;6;07.03.2023 00:00;54121;50066;4055;6.1
20044477;281795;6;07.03.2023 00:00;2732;2732;0;10.1
20046208;283613;6;08.03.2023 00:00;1;1;0;0.0
20046092;265674;6;08.03.2023 00:00;53021;52652;369;7.6
20046268;280895;6;08.03.2023 00:00;82781;64350;18431;7.6
20046270;280943;6;09.03.2023 00:00;72102;64352;7750;7.6
20046267;276810;6;09.03.2023 00:00;70900;64350;6550;7.5
20046080;277544;6;10.03.2023 00:00;106636;100132;6504;11.5
20046079;283345;6;11.03.2023 00:00;31436;25194;6242;3.8
20046035;254094;6;11.03.2023 00:00;629720;589680;40040;78.2
20046515;282401;6;14.03.2023 00:00;19993;15602;4391;2.2
20046514;281926;6;15.03.2023 00:00;66130;59280;6850;7.9
20046521;281652;6;15.03.2023 00:00;16270;12480;3790;1.8
20046518;263660;6;15.03.2023 00:00;28200;24960;3240;3.3
20046522;281726;6;15.03.2023 00:00;71200;62400;8800;8.4
20046520;279702;6;16.03.2023 00:00;49600;45240;4360;6.0
20046725;283332;6;16.03.2023 00:00;14500;12480;2020;1.7
20046523;282663;6;16.03.2023 00:00;50102;46802;3300;6.3
20046517;255997;6;17.03.2023 00:00;12502;10922;1580;1.5
20046672;280219;6;17.03.2023 00:00;14500;12480;2020;1.7
20046519;266786;6;17.03.2023 00:00;14200;12480;1720;1.6
20046649;274759;6;17.03.2023 00:00;295398;261690;33708;35.3
20046724;282195;6;17.03.2023 00:00;14500;12480;2020;1.7
20046674;283208;6;19.03.2023 00:00;59900;50064;9836;5.8
20046673;282851;6;19.03.2023 00:00;55800;50064;5736;5.8
20046670;270701;6;20.03.2023 00:00;37800;30213;7587;3.7
20046671;270705;6;20.03.2023 00:00;13378;11284;2094;1.5
20046669;256718;6;20.03.2023 00:00;47622;38976;8646;4.5
20046807;283358;6;21.03.2023 00:00;1170;1170;0;4.5
20046809;283477;6;21.03.2023 00:00;780;780;0;2.3
20046675;283425;6;21.03.2023 00:00;42600;17550;25050;2.1
20046388;;6;21.03.2023 00:00;0;0;0;0.0
20046872;282444;6;21.03.2023 00:00;94500;74844;19656;9.9
20047199;276641;6;22.03.2023 00:00;27422;25522;1900;3.0
20046871;281564;6;23.03.2023 00:00;36682;26682;10000;3.5
20047007;271997;6;23.03.2023 00:00;25002;17954;7048;2.0
20047207;282975;6;23.03.2023 00:00;70550;55556;14994;6.3
20047627;283843;6;24.03.2023 00:00;2816;2816;0;5.7
20047198;276396;6;24.03.2023 00:00;40400;35904;4496;4.3
20047197;276396;6;24.03.2023 00:00;38900;35904;2996;4.4
20047196;276393;6;25.03.2023 00:00;55100;52448;2652;5.8
20047203;281853;6;25.03.2023 00:00;104000;92929;11071;10.8
20047193;274892;6;25.03.2023 00:00;31000;27104;3896;3.2
20047204;281853;6;26.03.2023 00:00;33300;22528;10772;2.6
20047205;281853;6;26.03.2023 00:00;25200;22880;2320;2.7
20047201;281851;6;26.03.2023 00:00;53702;48578;5124;5.7
20047206;281854;6;26.03.2023 00:00;32900;27456;5444;3.4
20047202;281852;6;26.03.2023 00:00;29002;27458;1544;3.2
20047200;281850;6;27.03.2023 00:00;30500;27808;2692;3.4
20047194;275988;6;27.03.2023 00:00;110852;89630;21222;10.5
20047195;276033;6;27.03.2023 00:00;79800;67222;12578;7.8
20047191;246158;6;28.03.2023 00:00;26400;23086;3314;2.6
20047234;246160;6;28.03.2023 00:00;13002;10867;2135;1.3
20047236;276031;6;28.03.2023 00:00;74250;65863;8387;7.7
20047235;275986;6;29.03.2023 00:00;94770;89628;5142;10.3
20047237;;6;29.03.2023 00:00;0;0;0;0.0
20047479;272663;6;29.03.2023 00:00;78640;51480;27160;7.1
20048025;272663;6;30.03.2023 00:00;102100;88140;13960;12.0
20048023;266348;6;31.03.2023 00:00;112450;101400;11050;14.1
20048024;273260;6;31.03.2023 00:00;82500;66585;15915;9.5
20047477;229042;6;01.04.2023 00:00;169900;151320;18580;17.8
20047598;281415;6;02.04.2023 00:00;60200;50065;10135;5.7
20047597;275729;6;02.04.2023 00:00;53320;51072;2248;6.0
20047786;282463;6;03.04.2023 00:00;56000;50064;5936;5.9
20047785;281821;6;03.04.2023 00:00;106100;100800;5300;11.8
20047271;283790;6;04.04.2023 00:00;4000;4000;0;12.5
20047596;265674;6;04.04.2023 00:00;103200;93600;9600;12.4
20047599;282873;6;05.04.2023 00:00;20302;15552;4750;2.2
20047776;204905;6;05.04.2023 00:00;84188;77441;6747;10.6
20047777;210795;6;05.04.2023 00:00;120106;110467;9639;14.2
20047600;283481;6;06.04.2023 00:00;39043;33932;5111;4.3
20047601;283490;6;11.04.2023 00:00;41059;34320;6739;4.8
20048367;283510;6;11.04.2023 00:00;202203;168093;34110;20.0
20048141;265179;6;11.04.2023 00:00;2;2;0;0.0
20048198;;6;11.04.2023 00:00;0;0;0;0.0
20048366;283439;6;12.04.2023 00:00;77232;59136;18096;7.1
20048276;272030;6;13.04.2023 00:00;130102;117219;12883;13.6
20048277;272030;6;14.04.2023 00:00;124000;118272;5728;13.6
20048278;272030;6;14.04.2023 00:00;127950;122848;5102;14.1
20048302;272458;6;15.04.2023 00:00;96500;81480;15020;10.1
20048660;280879;6;15.04.2023 00:00;435955;384314;51641;45.9
20048469;257774;6;18.04.2023 00:00;51610;33793;17817;5.1
20048470;275496;6;19.04.2023 00:00;52840;38016;14824;5.3
20048268;283704;6;19.04.2023 00:00;7000;3395;3605;0.4
20048267;283359;6;19.04.2023 00:00;48700;38016;10684;5.1
20048528;216296;6;20.04.2023 00:00;38172;34453;3719;4.7
20048266;283232;6;20.04.2023 00:00;31500;27324;4176;3.5
20048265;271832;6;22.04.2023 00:00;69900;53820;16080;6.7
20048529;;6;22.04.2023 00:00;0;0;0;0.0
20048662;274591;6;23.04.2023 00:00;43178;34320;8858;5.0
20048663;283119;6;23.04.2023 00:00;146802;123240;23562;14.9
20048767;283474;6;24.04.2023 00:00;31350;23010;8340;2.7
20048771;283928;6;24.04.2023 00:00;42600;35881;6719;4.1
20048768;283656;6;25.04.2023 00:00;6890;4291;2599;1.5
20048770;283672;6;25.04.2023 00:00;63500;51090;12410;6.2
20048769;283670;6;25.04.2023 00:00;134600;127140;7460;14.7
20048766;281863;6;26.04.2023 00:00;67602;50064;17538;5.8
20048764;281621;6;27.04.2023 00:00;58700;53760;4940;6.2
20048840;282463;6;27.04.2023 00:00;266002;248642;17360;28.9
20048980;229876;6;28.04.2023 00:00;177410;168092;9318;19.6
20048975;222339;6;29.04.2023 00:00;49250;42120;7130;5.0
20048974;217841;6;30.04.2023 00:00;70402;65522;4880;7.5
20049462;;6;30.04.2023 00:00;0;0;0;0.0
20048976;283930;6;30.04.2023 00:00;1560;1560;0;3.2
20049083;265647;6;30.04.2023 00:00;43500;27160;16340;3.2
20048979;;6;30.04.2023 00:00;0;0;0;0.0
20049080;240537;6;01.05.2023 00:00;47902;43458;4444;5.0
20049081;240873;6;01.05.2023 00:00;73103;62470;10633;7.3
20049084;268402;6;01.05.2023 00:00;13500;10864;2636;1.2
20049085;274923;6;02.05.2023 00:00;62800;57960;4840;6.6
20049082;259701;6;02.05.2023 00:00;12502;10866;1636;1.3
20049353;281261;6;02.05.2023 00:00;1298;1298;0;2.2
20049086;279563;6;02.05.2023 00:00;199070;186912;12158;22.0
20049283;283927;6;03.05.2023 00:00;57036;57036;0;12.8
20049079;;6;04.05.2023 00:00;0;0;0;0.0
20049425;279703;6;04.05.2023 00:00;36002;26522;9480;3.5
20049894;279703;6;05.05.2023 00:00;18502;17162;1340;2.3
20049717;282031;6;05.05.2023 00:00;17500;10920;6580;2.3
20049718;282197;6;05.05.2023 00:00;12002;10922;1080;1.5
20049899;282031;6;05.05.2023 00:00;13500;10920;2580;1.5
20049896;280716;6;05.05.2023 00:00;23600;21060;2540;2.9
20049897;281652;6;05.05.2023 00:00;12000;10920;1080;1.4
20049715;276844;6;05.05.2023 00:00;12000;10920;1080;1.4
20049893;276844;6;05.05.2023 00:00;12640;10140;2500;1.5
20049898;281830;6;05.05.2023 00:00;14500;10920;3580;1.4
20049714;261309;6;06.05.2023 00:00;216612;196563;20049;26.8
20049895;280219;6;06.05.2023 00:00;18333;17940;393;2.6
20049892;276844;6;06.05.2023 00:00;22700;21840;860;3.1
20049424;277469;6;07.05.2023 00:00;336509;301036;35473;41.0
20049467;277544;6;09.05.2023 00:00;118402;100778;17624;11.5
20049491;280920;6;10.05.2023 00:00;2;2;0;0.0
20049577;279506;6;10.05.2023 00:00;234700;214500;20200;25.0
20049699;283924;6;12.05.2023 00:00;72265;64350;7915;7.6
20050224;280920;6;12.05.2023 00:00;117500;107250;10250;12.3
20049561;280920;6;13.05.2023 00:00;68652;64352;4300;7.6
20050228;280920;6;13.05.2023 00:00;223304;214502;8802;24.7
20049723;283726;6;14.05.2023 00:00;230200;218400;11800;25.4
20049696;281411;6;16.05.2023 00:00;120599;100802;19797;11.8
20049697;282846;6;17.05.2023 00:00;216685;200258;16427;23.4
20049934;281405;6;18.05.2023 00:00;158407;150528;7879;17.5
20049935;282851;6;18.05.2023 00:00;54895;51074;3821;6.1
20049933;278331;6;19.05.2023 00:00;53500;51072;2428;6.1
20049698;282892;6;19.05.2023 00:00;32068;28080;3988;3.4
20049931;257773;6;19.05.2023 00:00;39202;35282;3920;4.3
20049932;259586;6;20.05.2023 00:00;15600;12090;3510;1.5
20050045;273315;6;20.05.2023 00:00;30900;28470;2430;3.3
20050043;205988;6;20.05.2023 00:00;36232;33542;2690;3.8
20050044;265179;6;21.05.2023 00:00;36700;26520;10180;3.1
20050109;265177;6;21.05.2023 00:00;30500;27690;2810;3.3
20050112;283876;6;21.05.2023 00:00;66136;57720;8416;7.3
20050674;284313;6;22.05.2023 00:00;780;780;0;3.8
20050111;275189;6;22.05.2023 00:00;36500;35880;620;4.2
20049936;;6;22.05.2023 00:00;0;0;0;0.0
20050285;280879;6;22.05.2023 00:00;145992;129692;16300;15.2
20050388;281789;6;23.05.2023 00:00;35371;29197;6174;3.5
20050806;273125;6;24.05.2023 00:00;35831;26483;9348;3.4
20050385;234666;6;24.05.2023 00:00;44700;38766;5934;4.5
20050390;283510;6;24.05.2023 00:00;96742;89564;7178;10.5
20050389;281851;6;25.05.2023 00:00;36500;33440;3060;4.0
20050391;283966;6;25.05.2023 00:00;52542;41762;10780;5.2
20050690;274923;6;26.05.2023 00:00;31600;26910;4690;3.2
20050432;283834;6;26.05.2023 00:00;92061;73080;18981;8.6
20050386;276369;6;26.05.2023 00:00;26700;24360;2340;2.9
20050431;275924;6;27.05.2023 00:00;58100;53820;4280;6.4
20050446;271129;6;28.05.2023 00:00;95300;80730;14570;9.3
20050450;272443;6;28.05.2023 00:00;35802;35192;610;4.2
20050449;268269;6;28.05.2023 00:00;71300;62100;9200;8.3
20050686;283556;6;29.05.2023 00:00;83402;61112;22290;7.4
20050685;;6;29.05.2023 00:00;0;0;0;0.0
20050692;282526;6;29.05.2023 00:00;214250;202020;12230;27.0
20050691;277773;6;31.05.2023 00:00;15602;15602;0;6.0
20050867;277283;6;31.05.2023 00:00;35200;32370;2830;3.7
20050689;274759;6;31.05.2023 00:00;109802;102182;7620;14.6
20050687;274759;6;01.06.2023 00:00;114500;105300;9200;14.3
20050688;274759;6;02.06.2023 00:00;138002;130652;7350;17.7
20050769;282714;6;03.06.2023 00:00;67902;56552;11350;7.5
20050770;282714;6;03.06.2023 00:00;272612;251552;21060;33.9
20050868;284160;6;05.06.2023 00:00;33800;25840;7960;3.1
20050826;277544;6;05.06.2023 00:00;108800;100776;8024;11.8
20050827;277544;6;06.06.2023 00:00;111400;100776;10624;11.6
20050951;283208;6;07.06.2023 00:00;282900;251328;31572;29.3
20051051;281383;6;08.06.2023 00:00;57000;51072;5928;6.0
20051053;283870;6;09.06.2023 00:00;53702;51074;2628;6.0
20051047;278331;6;09.06.2023 00:00;53900;51072;2828;6.0
20051050;281378;6;09.06.2023 00:00;57488;51072;6416;6.0
20051052;281415;6;10.06.2023 00:00;55414;51074;4340;6.6
20051049;280125;6;10.06.2023 00:00;54502;51074;3428;5.9
20050767;270707;6;10.06.2023 00:00;69050;67340;1710;7.8
20051133;284230;6;11.06.2023 00:00;39000;35880;3120;4.3
20051064;274303;6;11.06.2023 00:00;20502;16382;4120;2.0
20051132;284227;6;11.06.2023 00:00;42500;35880;6620;4.1
20051439;281481;6;12.06.2023 00:00;36070;30030;6040;3.7
20051200;;6;12.06.2023 00:00;0;0;0;0.0
20051202;209946;6;12.06.2023 00:00;50000;43456;6544;5.1
20051201;209945;6;13.06.2023 00:00;48100;41419;6681;4.8
20051236;272458;6;13.06.2023 00:00;112200;95060;17140;11.1
20051241;284221;6;14.06.2023 00:00;19800;14080;5720;1.6
20051237;275113;6;14.06.2023 00:00;33400;24992;8408;3.2
20051240;282690;6;14.06.2023 00:00;59302;53506;5796;6.2
20051239;281854;6;14.06.2023 00:00;27700;25696;2004;3.0
20051339;281853;6;15.06.2023 00:00;66502;59138;7364;6.9
20051335;281850;6;15.06.2023 00:00;26800;25344;1456;3.0
20051337;281853;6;15.06.2023 00:00;11500;10560;940;1.3
20051338;281853;6;15.06.2023 00:00;30700;27456;3244;3.3
20051336;281852;6;16.06.2023 00:00;31400;28512;2888;3.3
20051434;279563;6;16.06.2023 00:00;204620;186912;17708;22.1
20051433;279563;6;17.06.2023 00:00;194470;186912;7558;21.6
20051552;279563;6;18.06.2023 00:00;200940;187561;13379;21.8
20051551;257195;6;19.06.2023 00:00;36042;27541;8501;3.4
20051590;283026;6;22.06.2023 00:00;449092;376742;72350;44.8
20051712;283026;6;27.06.2023 00:00;197110;188370;8740;22.0
20051775;277007;6;28.06.2023 00:00;40800;26910;13890;3.0
20051771;271129;6;28.06.2023 00:00;92580;80730;11850;9.4
20051781;272443;6;28.06.2023 00:00;21400;20700;700;2.3
20051456;279704;6;29.06.2023 00:00;39100;27841;11259;3.2
20051779;283966;6;29.06.2023 00:00;51302;41762;9540;5.0
20051780;283966;6;29.06.2023 00:00;43600;41760;1840;4.9
20051783;;6;30.06.2023 00:00;0;0;0;0.0
20051890;204905;6;30.06.2023 00:00;190400;169130;21270;20.6
20051996;215532;6;01.07.2023 00:00;21092;15863;5229;1.8
20051891;282873;6;01.07.2023 00:00;18000;15861;2139;2.0
20051998;273267;6;01.07.2023 00:00;115902;97982;17920;12.8
20051997;231571;6;01.07.2023 00:00;17502;15863;1639;2.0
20052192;273260;6;02.07.2023 00:00;99070;89355;9715;11.6
20052103;281859;6;03.07.2023 00:00;176730;165360;11370;21.3
20052156;279877;6;04.07.2023 00:00;34502;31202;3300;4.2
20052157;282399;6;04.07.2023 00:00;29100;21840;7260;2.9
20052154;271298;6;05.07.2023 00:00;27870;21840;6030;2.8
20052159;282663;6;05.07.2023 00:00;16000;14430;1570;1.9
20052158;279879;6;05.07.2023 00:00;28000;27300;700;3.6
20052155;279702;6;05.07.2023 00:00;55002;49922;5080;6.5
20052177;283839;6;06.07.2023 00:00;12502;10922;1580;1.4
20052176;283838;6;06.07.2023 00:00;14002;12482;1520;1.7
20052160;283335;6;06.07.2023 00:00;12002;10532;1470;1.4
20052172;279703;6;06.07.2023 00:00;23800;21840;1960;2.9
20052171;263660;6;06.07.2023 00:00;23800;21060;2740;2.8
20052174;282196;6;06.07.2023 00:00;13400;10920;2480;1.5
20052193;282664;6;06.07.2023 00:00;13100;10920;2180;1.5
20052173;281831;6;06.07.2023 00:00;17000;16380;620;2.2
20052175;282401;6;06.07.2023 00:00;29602;26523;3079;3.5
20051826;282463;6;07.07.2023 00:00;286520;255361;31159;30.0
20052357;281620;6;08.07.2023 00:00;56180;51072;5108;5.9
20052398;283932;6;09.07.2023 00:00;323745;299712;24033;34.2
20052752;281411;6;10.07.2023 00:00;226523;206976;19547;23.9
20052750;259200;6;12.07.2023 00:00;20840;10473;10367;2.0
20052749;252622;6;12.07.2023 00:00;57170;46376;10794;5.5
20052754;283119;6;12.07.2023 00:00;75862;71372;4490;7.9
20052753;281481;6;13.07.2023 00:00;40600;29640;10960;3.6
20052751;275606;6;13.07.2023 00:00;31090;29640;1450;3.6
20052801;;6;14.07.2023 00:00;0;0;0;0.0
20052810;282444;6;14.07.2023 00:00;81890;61776;20114;7.7
20052802;274318;6;14.07.2023 00:00;110300;85019;25281;9.8
20052803;280879;6;15.07.2023 00:00;32506;23767;8739;3.6
20052804;281629;6;15.07.2023 00:00;240646;190240;50406;22.8
20052805;281851;6;17.07.2023 00:00;28945;18307;10638;2.7
20053199;282690;6;17.07.2023 00:00;56167;50688;5479;6.2
20052806;284592;6;18.07.2023 00:00;24500;19009;5491;2.2
20052974;284730;6;18.07.2023 00:00;56824;49282;7542;5.8
20053198;275117;6;18.07.2023 00:00;61578;54560;7018;6.3
20052913;275567;6;19.07.2023 00:00;35900;32736;3164;3.7
20052918;284147;6;19.07.2023 00:00;138033;107641;30392;13.3
20053382;284147;6;20.07.2023 00:00;89767;80730;9037;9.9
20053381;266011;6;20.07.2023 00:00;125670;115231;10439;14.3
20053041;273121;6;21.07.2023 00:00;94118;84872;9246;10.0
20053063;276726;6;22.07.2023 00:00;24854;12180;12674;1.8
20053590;281629;6;22.07.2023 00:00;68920;62060;6860;7.2
20053058;284632;6;22.07.2023 00:00;34802;34802;0;9.7
20053057;284637;6;23.07.2023 00:00;35904;35904;0;7.6
20053573;284907;6;23.07.2023 00:00;580;580;0;1.0
20053073;284287;6;23.07.2023 00:00;1742;1742;0;3.4
20053112;;6;23.07.2023 00:00;0;0;0;0.0
20053202;271183;6;23.07.2023 00:00;123802;91667;32135;10.9
20053203;271516;6;25.07.2023 00:00;357474;296725;60749;37.8
20053222;263463;6;27.07.2023 00:00;97547;70618;26929;10.1
20053201;;6;28.07.2023 00:00;0;0;0;0.0
20053463;268719;6;28.07.2023 00:00;37455;29640;7815;4.2
20053229;228979;6;29.07.2023 00:00;32453;25351;7102;2.9
20053517;283490;6;14.08.2023 00:00;41102;29642;11460;3.5
20053516;283481;6;14.08.2023 00:00;30166;27301;2865;3.2
20054416;284801;6;14.08.2023 00:00;16740;10920;5820;1.6
20054334;284072;6;15.08.2023 00:00;18062;15602;2460;2.1
20054337;284797;6;15.08.2023 00:00;13000;10920;2080;1.7
20054327;280212;6;15.08.2023 00:00;13000;10920;2080;1.6
20054338;284802;6;15.08.2023 00:00;11593;10922;671;1.5
20054335;284188;6;15.08.2023 00:00;25227;20282;4945;3.1
20054329;280716;6;15.08.2023 00:00;24163;21841;2322;2.9
20054318;271298;6;16.08.2023 00:00;23000;21840;1160;2.9
20054326;279879;6;16.08.2023 00:00;23718;20281;3437;2.8
20054328;280219;6;16.08.2023 00:00;42502;40172;2330;5.3
20054330;282401;6;16.08.2023 00:00;27000;26520;480;3.6
20054331;282714;6;17.08.2023 00:00;113702;97502;16200;12.6
20054324;273267;6;17.08.2023 00:00;119300;111435;7865;14.8
20054336;284548;6;18.08.2023 00:00;114788;100779;14009;13.6
20054332;283084;6;19.08.2023 00:00;58236;50389;7847;6.45
20054325;277469;6;19.08.2023 00:00;327800;301036;26764;38.4
20054333;283345;6;19.08.2023 00:00;28002;25842;2160;3.4
20054321;283908;6;21.08.2023 00:00;91802;81902;9900;9.5
20054442;269561;6;22.08.2023 00:00;51600;44071;7529;5.0
20054499;;6;22.08.2023 00:00;0;0;0;0.0
20054650;280040;6;22.08.2023 00:00;178092;128306;49786;16.7
20054503;284942;6;24.08.2023 00:00;52500;38017;14483;5.3
20054501;216296;6;24.08.2023 00:00;39402;31484;7918;3.7
20054539;276119;6;25.08.2023 00:00;90200;82360;7840;10.0
20054646;283834;6;25.08.2023 00:00;81600;69600;12000;8.0
20055114;271129;6;26.08.2023 00:00;98910;80730;18180;9.4
20055113;266011;6;26.08.2023 00:00;116390;107640;8750;12.4
20054649;284992;6;27.08.2023 00:00;51800;28421;23379;3.3
20054647;283966;6;27.08.2023 00:00;54700;41760;12940;4.9
20054648;284962;6;28.08.2023 00:00;34702;26102;8600;3.0
20054849;284430;6;28.08.2023 00:00;330200;296960;33240;35.1
20054967;284430;6;30.08.2023 00:00;330000;294640;35360;33.8
20054904;277061;6;31.08.2023 00:00;14500;12223;2277;1.4
20054923;281687;6;01.09.2023 00:00;116602;95825;20777;11.3
20054966;281687;6;01.09.2023 00:00;92350;83811;8539;9.6
20055039;272458;6;02.09.2023 00:00;146300;126294;20006;14.7
20055036;280879;6;03.09.2023 00:00;70502;64507;5995;7.2
20055032;271845;6;03.09.2023 00:00;25070;25125;-55;3.1
20054644;283555;6;04.09.2023 00:00;140990;96122;44868;12.1
20054645;283555;6;05.09.2023 00:00;112344;86400;25944;10.5
20054970;282226;6;06.09.2023 00:00;66583;56160;10423;6.8
20054971;282226;6;06.09.2023 00:00;40590;38880;1710;4.4
20055037;;6;06.09.2023 00:00;0;0;0;0.0
20055068;270701;6;06.09.2023 00:00;43989;33490;10499;3.9
20055069;270702;6;07.09.2023 00:00;49502;45138;4364;5.3
20055177;282892;6;07.09.2023 00:00;54500;37830;16670;4.2
20055070;284584;6;07.09.2023 00:00;70604;60844;9760;7.3
20055178;284584;6;08.09.2023 00:00;64060;59282;4778;7.1
20055287;283870;6;08.09.2023 00:00;66044;51074;14970;5.8
20055285;281502;6;09.09.2023 00:00;54647;53763;884;6.1
20055284;280540;6;09.09.2023 00:00;127640;109202;18438;12.8
20055286;281799;6;09.09.2023 00:00;17806;10923;6883;1.6
20055288;285116;6;10.09.2023 00:00;20280;20280;0;8.0
20055795;285147;6;10.09.2023 00:00;43900;31008;12892;3.6
20055290;284408;6;11.09.2023 00:00;33042;25842;7200;3.4
20055292;285011;6;11.09.2023 00:00;48947;40922;8025;5.3
20055293;285040;6;11.09.2023 00:00;26173;25842;331;3.6
20055357;283382;6;12.09.2023 00:00;204602;179258;25344;20.6
20055341;;6;12.09.2023 00:00;0;0;0;0.0
20055460;283321;6;13.09.2023 00:00;128500;119504;8996;13.8
20055515;283318;6;14.09.2023 00:00;125802;119506;6296;13.8
20055516;283380;6;14.09.2023 00:00;197600;179256;18344;20.9
20055616;281853;6;15.09.2023 00:00;96900;76736;20164;8.7
20055614;281850;6;16.09.2023 00:00;30467;26051;4416;3.5
20055615;281851;6;16.09.2023 00:00;28103;25698;2405;3.1
20055613;276596;6;17.09.2023 00:00;60367;49280;11087;5.6
20055617;284730;6;17.09.2023 00:00;28000;27104;896;3.0
20055612;270508;6;17.09.2023 00:00;77670;66199;11471;7.6
20055771;276369;6;18.09.2023 00:00;76332;64962;11370;7.5
20055769;268269;6;18.09.2023 00:00;55100;49680;5420;6.5
20055772;285148;6;19.09.2023 00:00;15050;10864;4186;1.6
20056072;283555;6;19.09.2023 00:00;55574;34564;21010;4.4
20055354;;6;20.09.2023 00:00;0;0;0;0.0
20055355;265317;6;20.09.2023 00:00;33100;27161;5939;3.1
20055927;;6;20.09.2023 00:00;0;0;0;0.0
20055933;283119;6;20.09.2023 00:00;71100;63960;7140;7.4
20055935;284970;6;21.09.2023 00:00;30900;28080;2820;3.2
20055930;275547;6;21.09.2023 00:00;49500;40560;8940;4.8
20055929;275545;6;21.09.2023 00:00;45700;40560;5140;4.7
20055931;276580;6;22.09.2023 00:00;276700;249600;27100;28.6
20055984;277544;6;23.09.2023 00:00;144815;124681;20134;14.5
20056071;284750;6;24.09.2023 00:00;24988;25840;-852;3.1
20056307;282401;6;24.09.2023 00:00;35862;26522;9340;3.5
20056395;281926;6;25.09.2023 00:00;157400;149760;7640;19.4
20056401;284070;6;25.09.2023 00:00;53802;47192;6610;6.0
20056392;279703;6;26.09.2023 00:00;18000;14041;3959;1.9
20056400;283838;6;26.09.2023 00:00;13500;10920;2580;1.5
20056396;282031;6;26.09.2023 00:00;14500;10920;3580;1.4
20056391;276848;6;26.09.2023 00:00;12000;10920;1080;1.4
20056389;263660;6;26.09.2023 00:00;23000;21450;1550;2.8
20056393;279769;6;26.09.2023 00:00;11600;10920;680;1.4
20056402;285040;6;27.09.2023 00:00;30232;25842;4390;3.5
20056397;282393;6;27.09.2023 00:00;20600;20280;320;2.8
20056394;279879;6;27.09.2023 00:00;13600;10920;2680;1.5
20056399;283084;6;27.09.2023 00:00;54900;51680;3220;6.7
20056390;274759;6;27.09.2023 00:00;355300;325650;29650;42.7
20056398;282714;6;29.09.2023 00:00;56895;50702;6193;6.9
20056070;271845;6;30.09.2023 00:00;36252;23088;13164;3.8
20055928;;6;30.09.2023 00:00;0;0;0;0.0
20055619;284950;6;01.10.2023 00:00;143777;129922;13855;15.2
20055770;276118;6;01.10.2023 00:00;73057;69022;4035;8.1
20056075;276119;6;02.10.2023 00:00;112620;106140;6480;12.1
20056403;274923;6;02.10.2023 00:00;64402;54512;9890;6.2
20056404;274923;6;03.10.2023 00:00;87002;81422;5580;9.1
20056639;273121;6;04.10.2023 00:00;88600;80730;7870;9.5
20056637;273121;6;05.10.2023 00:00;113702;107642;6060;12.7
20056638;273121;6;05.10.2023 00:00;197650;188370;9280;21.8
20057013;281853;6;06.10.2023 00:00;244320;218944;25376;26.2
20057014;285459;6;16.10.2023 00:00;300701;271648;29053;31.6
20056198;280400;6;17.10.2023 00:00;170053;141234;28819;16.5
20056196;;6;17.10.2023 00:00;0;0;0;0.0
20056197;271516;6;18.10.2023 00:00;621870;564928;56942;67.0
20057145;;6;22.10.2023 00:00;0;0;0;0.0
20057143;285565;6;22.10.2023 00:00;71190;61110;10080;7.3
20057428;285601;6;22.10.2023 00:00;679;679;0;2.0
20057163;259701;6;23.10.2023 00:00;13500;10185;3315;1.2
20057106;259700;6;23.10.2023 00:00;15600;10864;4736;1.3
20057193;259061;6;23.10.2023 00:00;13000;10185;2815;1.3
20057191;240537;6;23.10.2023 00:00;40426;35989;4437;4.1
20057192;240538;6;23.10.2023 00:00;38500;35308;3192;4.0
20057190;240525;6;23.10.2023 00:00;38750;35308;3442;4.4
20057250;240873;6;24.10.2023 00:00;72500;70616;1884;8.1
20057254;284827;6;24.10.2023 00:00;10864;10864;0;1.4
20057252;276369;6;24.10.2023 00:00;74102;68442;5660;7.9
20057290;284147;6;25.10.2023 00:00;86250;80730;5520;9.2
20057288;271832;6;25.10.2023 00:00;57102;52442;4660;5.9
20057107;280879;6;26.10.2023 00:00;70400;61110;9290;7.1
20057752;285248;6;26.10.2023 00:00;2252;1949;303;0.2
20056195;;6;26.10.2023 00:00;0;0;0;0.0
20057258;285603;6;26.10.2023 00:00;2;2;0;13.8
20057310;275189;6;27.10.2023 00:00;34000;26130;7870;3.0
20057311;275191;6;27.10.2023 00:00;16100;15600;500;1.9
20057368;284951;6;27.10.2023 00:00;30300;26130;4170;3.0
20057369;285413;6;28.10.2023 00:00;12080;8581;3499;11.3
20057632;281112;6;28.10.2023 00:00;47000;43290;3710;5.0
20057638;281420;6;28.10.2023 00:00;32300;26520;5780;3.5
20057640;281831;6;29.10.2023 00:00;70900;60840;10060;8.0
20057650;284856;6;29.10.2023 00:00;11300;10920;380;1.4
20057634;276848;6;29.10.2023 00:00;19330;10900;8430;1.4
20057630;271298;6;29.10.2023 00:00;23000;21450;1550;2.7
20057649;284467;6;29.10.2023 00:00;12500;10920;1580;1.4
20057643;282197;6;30.10.2023 00:00;12802;10922;1880;1.4
20057639;281652;6;30.10.2023 00:00;12200;10920;1280;1.5
20057645;283332;6;30.10.2023 00:00;12500;10920;1580;1.5
20057633;263660;6;30.10.2023 00:00;26002;21842;4160;2.7
20057635;279703;6;30.10.2023 00:00;12703;10533;2170;1.4
20057642;282031;6;30.10.2023 00:00;13502;10922;2580;1.3
20057648;284219;6;30.10.2023 00:00;31860;24960;6900;3.1
20057647;284188;6;30.10.2023 00:00;23000;21840;1160;2.8
20057646;283838;6;31.10.2023 00:00;13702;10922;2780;1.4
20057637;281419;6;31.10.2023 00:00;26000;20280;5720;2.6
20057636;280716;6;31.10.2023 00:00;23000;21060;1940;2.8
20057641;281926;6;31.10.2023 00:00;58183;51092;7091;6.8
20057644;282401;6;31.10.2023 00:00;16729;17160;-431;2.4
20057631;273267;6;01.11.2023 00:00;158416;143177;15239;19.3
20057804;273260;6;02.11.2023 00:00;129055;117302;11753;15.3
20058172;285585;6;02.11.2023 00:00;23400;23400;0;8.6
20058173;285583;6;03.11.2023 00:00;22620;22620;0;7.7
20057949;285115;6;03.11.2023 00:00;3368;3368;0;6.2
20057948;282096;6;03.11.2023 00:00;2342;2342;0;3.0
20057659;;6;03.11.2023 00:00;0;0;0;0.0
20057962;273863;6;04.11.2023 00:00;39722;31680;8042;3.6
20057992;276596;6;04.11.2023 00:00;33100;25345;7755;2.9
20057994;281853;6;04.11.2023 00:00;65100;59136;5964;7.1
20057993;281362;6;05.11.2023 00:00;2670;2037;633;0.3
20057963;274923;6;05.11.2023 00:00;68332;53822;14510;6.3
20057710;281525;6;05.11.2023 00:00;62520;52200;10320;6.2
20057709;276116;6;06.11.2023 00:00;19600;17400;2200;2.1
20057707;271129;6;06.11.2023 00:00;91302;80732;10570;9.4
20057961;272735;6;06.11.2023 00:00;87100;80730;6370;9.5
20057660;271833;6;07.11.2023 00:00;154760;140760;14000;16.4
20057787;275496;6;08.11.2023 00:00;80500;60544;19956;8.4
20057711;281629;6;08.11.2023 00:00;311200;264480;46720;31.9
20057788;283966;6;10.11.2023 00:00;53302;45822;7480;5.5
20057991;276033;6;11.11.2023 00:00;35750;29876;5874;3.5
20057990;276031;6;11.11.2023 00:00;29900;29876;24;3.5
20058168;;6;11.11.2023 00:00;0;0;0;0.0
20057989;271183;6;11.11.2023 00:00;90470;61110;29360;8.5
20058086;271516;6;12.11.2023 00:00;388500;335426;53074;39.1
20058090;;6;14.11.2023 00:00;0;0;0;0.0
20058226;285002;6;14.11.2023 00:00;37097;30030;7067;3.6
20058223;283656;6;15.11.2023 00:00;4080;2343;1737;2.5
20058225;283672;6;15.11.2023 00:00;55792;47193;8599;5.4
20058224;283670;6;15.11.2023 00:00;128391;121682;6709;13.9
20058222;270708;6;16.11.2023 00:00;14003;11651;2352;1.3
20058219;270698;6;16.11.2023 00:00;16500;11648;4852;2.3
20058220;270704;6;16.11.2023 00:00;26500;24024;2476;2.8
20058221;270707;6;16.11.2023 00:00;18700;16016;2684;2.0
20058310;275439;6;17.11.2023 00:00;98802;84450;14352;9.9
20058312;282892;6;17.11.2023 00:00;29600;27300;2300;3.2
20058315;284960;6;17.11.2023 00:00;60690;54600;6090;6.2
20058314;283208;6;18.11.2023 00:00;166297;150531;15766;17.8
20058610;280134;6;19.11.2023 00:00;55800;51072;4728;5.9
20058611;281383;6;19.11.2023 00:00;56350;52080;4270;6.2
20058761;266348;6;19.11.2023 00:00;91700;85800;5900;11.9
20058762;279769;6;20.11.2023 00:00;21800;14040;7760;1.8
20058767;284219;6;20.11.2023 00:00;17002;15602;1400;2.0
20058768;284802;6;20.11.2023 00:00;17002;15602;1400;2.0
20058763;281565;6;20.11.2023 00:00;16002;14042;1960;1.7
20058766;284071;6;20.11.2023 00:00;32500;26520;5980;3.3
20058764;282714;6;21.11.2023 00:00;60300;50700;9600;6.5
20058845;284959;6;21.11.2023 00:00;15000;14040;960;2.0
20058844;284798;6;21.11.2023 00:00;18000;14040;3960;1.8
20058765;283474;6;22.11.2023 00:00;36200;32760;3440;3.9
20058348;275547;6;22.11.2023 00:00;24002;18722;5280;2.1
20058311;275548;6;22.11.2023 00:00;45002;40562;4440;4.8
20058612;284970;6;23.11.2023 00:00;29800;27300;2500;3.2
20058313;283119;6;23.11.2023 00:00;96002;85802;10200;9.7
20058329;285532;6;23.11.2023 00:00;33100;28860;4240;3.5
20058420;285790;6;24.11.2023 00:00;45602;35642;9960;4.2
20058309;;6;24.11.2023 00:00;0;0;0;0.0
20058608;265996;6;24.11.2023 00:00;33019;27001;6018;3.1
20058418;268269;6;25.11.2023 00:00;56400;49681;6719;6.5
20058445;266011;6;26.11.2023 00:00;77800;70380;7420;8.2
20058503;272735;6;26.11.2023 00:00;129200;107640;21560;12.4
20058769;271832;6;26.11.2023 00:00;56072;50373;5699;5.9
20058913;285608;6;27.11.2023 00:00;13600;10864;2736;1.3
20058912;285607;6;27.11.2023 00:00;47100;44814;2286;5.3
20058906;285833;6;27.11.2023 00:00;35502;26102;9400;3.0
20058905;285372;6;28.11.2023 00:00;34900;27840;7060;3.3
20058931;285372;6;28.11.2023 00:00;29800;27840;1960;3.3
20058908;285686;6;28.11.2023 00:00;86802;73335;13467;8.3
20058502;253641;6;29.11.2023 00:00;28500;18304;10196;2.4
20058566;257774;6;29.11.2023 00:00;49600;42240;7360;5.2
20058569;285760;6;30.11.2023 00:00;36055;27778;8277;3.9
20058567;280879;6;30.11.2023 00:00;138583;126296;12287;14.7
20059232;274300;6;01.12.2023 00:00;125359;111234;14125;13.1
20058914;;6;02.12.2023 00:00;0;0;0;0.0
20059004;271507;6;02.12.2023 00:00;53800;48360;5440;5.7
20059007;285597;6;02.12.2023 00:00;7502;5072;2430;0.6
20059005;271509;6;02.12.2023 00:00;95302;93212;2090;10.8
20059006;271512;6;03.12.2023 00:00;141736;120900;20836;14.1
20058609;275189;6;04.12.2023 00:00;41551;30423;11128;3.5
20060401;275569;6;25.01.2024 00:00;28002;24962;3040;4.3
20060572;286386;6;25.01.2024 00:00;5070;5070;0;2.5
20060723;285767;6;25.01.2024 00:00;99252;82293;16959;9.2
20060398;268657;6;26.01.2024 00:00;51450;41340;10110;5.0
20060402;282029;6;27.01.2024 00:00;27400;20280;7120;2.3
20060409;286220;6;27.01.2024 00:00;41200;26880;14320;3.1
20060395;210795;6;28.01.2024 00:00;73602;55361;18241;7.1
20060396;215474;6;28.01.2024 00:00;18602;15864;2738;1.9
20060397;231571;6;29.01.2024 00:00;19253;15864;3389;1.8
20060399;275189;6;29.01.2024 00:00;47400;30420;16980;4.1
20060400;275189;6;29.01.2024 00:00;34102;30812;3290;3.6
20060408;286217;6;30.01.2024 00:00;15750;11700;4050;1.4
20060415;;6;30.01.2024 00:00;0;0;0;0.0
20060407;285648;6;30.01.2024 00:00;44352;31202;13150;3.7
20060413;;6;31.01.2024 00:00;0;0;0;0.0
20060573;286387;6;31.01.2024 00:00;5220;5220;0;4.3
20060403;283966;6;31.01.2024 00:00;208103;171683;36420;19.9
20060406;284430;6;01.02.2024 00:00;34400;25521;8879;3.0
20060404;283966;6;01.02.2024 00:00;39000;37120;1880;4.1
20060405;284430;6;02.02.2024 00:00;430952;392662;38290;44.2
20060877;284962;6;04.02.2024 00:00;30900;26680;4220;3.2
20060879;285833;6;04.02.2024 00:00;27502;25522;1980;3.0
20061383;286562;6;04.02.2024 00:00;580;580;0;7.4
20060878;284962;6;04.02.2024 00:00;29800;27840;1960;3.2
20060880;286016;6;05.02.2024 00:00;4039;5434;-1395;5.2
20060876;270508;6;05.02.2024 00:00;52600;44132;8468;5.1
20060958;285801;6;05.02.2024 00:00;114450;96052;18398;11.0
20060956;276116;6;06.02.2024 00:00;21500;18561;2939;2.1
20060957;283834;6;07.02.2024 00:00;28100;20880;7220;2.5
20060955;272735;6;07.02.2024 00:00;37700;26910;10790;3.1
20060954;271129;6;07.02.2024 00:00;29300;26910;2390;3.2
20060953;271129;6;07.02.2024 00:00;31800;26910;4890;3.0
20060992;271129;6;08.02.2024 00:00;39200;26910;12290;2.5
20060991;271129;6;08.02.2024 00:00;67302;61412;5890;7.2
20061076;273121;6;08.02.2024 00:00;211382;188372;23010;21.1
20060993;273121;6;10.02.2024 00:00;82000;80730;1270;9.3
20061129;281525;6;10.02.2024 00:00;82252;72502;9750;8.4
20061213;276369;6;10.02.2024 00:00;181052;164723;16329;18.8
20061210;259701;6;11.02.2024 00:00;15600;12222;3378;1.4
20061209;259061;6;12.02.2024 00:00;14600;10864;3736;1.3
20061211;259702;6;12.02.2024 00:00;13600;10864;2736;1.3
20061212;268402;6;12.02.2024 00:00;12000;10864;1136;1.2
20061207;240525;6;12.02.2024 00:00;68800;65185;3615;7.7
20061208;240537;6;12.02.2024 00:00;79600;70617;8983;8.1
20061437;240873;6;13.02.2024 00:00;106100;100492;5608;11.5
20061436;240538;6;14.02.2024 00:00;99034;70618;28416;6.9
20061858;286721;6;14.02.2024 00:00;3;3;0;4.6
20061453;271833;6;16.02.2024 00:00;836909;780392;56517;90.0
20061914;274301;6;21.02.2024 00:00;22652;17602;5050;2.0
20061915;280584;6;21.02.2024 00:00;32500;29920;2580;3.5
20061918;284803;6;21.02.2024 00:00;134802;128482;6320;14.6
20061872;281853;6;22.02.2024 00:00;223190;201344;21846;22.9
20061747;285995;6;24.02.2024 00:00;353472;327056;26416;37.2
20061917;282971;6;25.02.2024 00:00;63050;55556;7494;6.5
20061911;209945;6;26.02.2024 00:00;47402;40742;6660;4.7
20061912;209946;6;26.02.2024 00:00;47450;42777;4673;4.9
20061913;271845;6;27.02.2024 00:00;27340;25123;2217;2.8
20061916;280879;6;27.02.2024 00:00;87962;78087;9875;9.3
20061746;284942;6;28.02.2024 00:00;43200;35641;7559;4.3
20061921;;6;28.02.2024 00:00;0;0;0;0.0
20062167;211506;6;28.02.2024 00:00;113800;76500;37300;9.2
20061968;283629;6;29.02.2024 00:00;1058;1058;0;4.0
20061966;275092;6;29.02.2024 00:00;679;679;0;0.2
20061967;283622;6;01.03.2024 00:00;1556;1057;499;6.0
20062168;271183;6;01.03.2024 00:00;158000;126294;31706;14.8
20062169;271516;6;02.03.2024 00:00;111960;100492;11468;11.6
20062355;280400;6;03.03.2024 00:00;664920;600917;64003;69.2
20062717;286407;6;06.03.2024 00:00;39752;32403;7349;3.7
20063014;286968;6;06.03.2024 00:00;38569;38569;0;16.0
20062604;286754;6;07.03.2024 00:00;14781;14781;0;3.2
20062509;273566;6;07.03.2024 00:00;34212;27691;6521;3.3
20062478;;6;07.03.2024 00:00;0;0;0;0.0
20062511;284584;6;08.03.2024 00:00;118780;106471;12309;12.3
20062510;281502;6;09.03.2024 00:00;61002;51746;9256;5.9
20062599;286220;6;09.03.2024 00:00;57500;51072;6428;6.0
20062597;281411;6;09.03.2024 00:00;109300;99456;9844;11.4
20062596;281378;6;10.03.2024 00:00;119400;107856;11544;12.5
20062598;282846;6;11.03.2024 00:00;108502;101810;6692;11.6
20062632;286347;6;11.03.2024 00:00;113800;107520;6280;12.4
20062630;270705;6;12.03.2024 00:00;18700;10192;8508;1.1
20062629;270704;6;12.03.2024 00:00;21700;20748;952;2.5
20062627;270701;6;12.03.2024 00:00;60700;50596;10104;6.3
20062631;270707;6;12.03.2024 00:00;22500;21476;1024;2.7
20062628;270703;6;13.03.2024 00:00;13600;11648;1952;1.3
20062675;257773;6;13.03.2024 00:00;93902;88034;5868;10.2
20063345;;6;13.03.2024 00:00;0;0;0;0.0
20063347;286968;6;14.03.2024 00:00;39502;39502;0;17.5
20063356;211506;6;14.03.2024 00:00;93000;76500;16500;9.3
20063346;;6;15.03.2024 00:00;0;0;0;0.0
20063272;215535;6;15.03.2024 00:00;24100;15861;8239;2.0
20062734;215532;6;15.03.2024 00:00;26500;23636;2864;2.8
20062733;210811;6;15.03.2024 00:00;36900;31722;5178;3.8
20062732;210795;6;16.03.2024 00:00;42300;39497;2803;4.6
20062740;277283;6;16.03.2024 00:00;70400;59670;10730;6.9
20062739;275189;6;16.03.2024 00:00;158300;145080;13220;16.5
20062731;;6;17.03.2024 00:00;0;0;0;0.0
20062940;286072;6;18.03.2024 00:00;117100;112640;4460;13.0
20062913;278994;6;18.03.2024 00:00;37902;30274;7628;3.6
20062939;278997;6;19.03.2024 00:00;27002;25346;1656;1.2
20062912;276393;6;19.03.2024 00:00;79702;76739;2963;8.7
20062915;284592;6;19.03.2024 00:00;18900;16192;2708;1.9
20063131;286867;6;20.03.2024 00:00;15500;12331;3169;1.5
20062911;272458;6;20.03.2024 00:00;40700;35308;5392;4.0
20063079;286402;6;20.03.2024 00:00;39100;25520;13580;3.1
20063125;286404;6;21.03.2024 00:00;31330;26680;4650;3.1
20063127;286577;6;21.03.2024 00:00;52692;49882;2810;6.2
20063707;287031;6;21.03.2024 00:00;47663;17002;30661;2.4
20063126;286405;6;22.03.2024 00:00;239800;217500;22300;25.2
20063706;;6;22.03.2024 00:00;0;0;0;0.0
20063195;286690;6;23.03.2024 00:00;30300;29198;1102;3.3
20063192;283927;6;24.03.2024 00:00;85802;85802;0;18.6
20063190;278711;6;24.03.2024 00:00;220819;186912;33907;22.0
20063213;265996;6;26.03.2024 00:00;29754;26462;3292;3.2
20063211;257250;6;27.03.2024 00:00;28148;25920;2228;3.0
20063293;257195;6;27.03.2024 00:00;79802;75062;4740;8.9
20063212;260193;6;27.03.2024 00:00;28500;25920;2580;2.9
20063295;270508;6;28.03.2024 00:00;85358;81127;4231;9.9
20063475;;6;28.03.2024 00:00;0;0;0;0.0
20063477;284351;6;28.03.2024 00:00;71700;65184;6516;7.4
20063081;281926;6;02.04.2024 00:00;62182;51482;10700;6.7
20063474;;6;02.04.2024 00:00;0;0;0;0.0
20063080;281420;6;03.04.2024 00:00;32850;26520;6330;3.5
20063019;279877;6;03.04.2024 00:00;31200;31200;0;4.2
20063021;282663;6;03.04.2024 00:00;30502;28083;2419;3.6
20063018;279702;6;03.04.2024 00:00;45000;34320;10680;4.6
20063020;281831;6;04.04.2024 00:00;34000;32760;1240;4.2
20062987;284071;6;04.04.2024 00:00;33600;31200;2400;4.2
20062986;279703;6;04.04.2024 00:00;35947;33542;2405;4.5
20062932;285655;6;04.04.2024 00:00;71597;65522;6075;7.7
20062924;282031;6;05.04.2024 00:00;22650;19500;3150;2.5
20062925;282197;6;05.04.2024 00:00;11502;10142;1360;1.2
20062923;281652;6;05.04.2024 00:00;14002;12482;1520;1.4
20063205;285032;6;05.04.2024 00:00;11795;10922;873;1.6
20062927;284072;6;05.04.2024 00:00;13500;10920;2580;1.4
20063204;274759;6;05.04.2024 00:00;207407;183300;24107;24.1
20063795;277469;6;07.04.2024 00:00;174502;155688;18814;20.1
20063794;281112;6;08.04.2024 00:00;45224;40562;4662;5.4
20063796;287033;6;08.04.2024 00:00;9558;9558;0;4.4
20063793;266176;6;08.04.2024 00:00;196900;170040;26860;20.8
20063913;257198;6;10.04.2024 00:00;32634;26126;6508;3.2
20064133;286986;6;10.04.2024 00:00;63692;53761;9931;6.2
20064134;286986;6;11.04.2024 00:00;52700;51408;1292;5.8
20064129;281621;6;11.04.2024 00:00;58200;52416;5784;6.1
20064128;281383;6;11.04.2024 00:00;30500;26880;3620;3.0
20064130;283672;6;11.04.2024 00:00;27500;26520;980;3.2
20064124;265179;6;12.04.2024 00:00;65500;54600;10900;6.6
20064121;231571;6;12.04.2024 00:00;24714;10885;13829;1.5
20064120;204905;6;13.04.2024 00:00;107588;100144;7444;11.6
20064131;286577;6;13.04.2024 00:00;105200;88160;17040;10.5
20064119;;6;13.04.2024 00:00;0;0;0;0.0
20064135;286997;6;14.04.2024 00:00;210302;192562;17740;22.9
20064126;272735;6;15.04.2024 00:00;103595;80730;22865;10.0
20064125;272735;6;16.04.2024 00:00;64502;58652;5850;6.8
20064123;255030;6;16.04.2024 00:00;38900;31051;7849;3.5
20064122;255030;6;16.04.2024 00:00;101000;95910;5090;11.6
20064127;278711;6;17.04.2024 00:00;206944;186910;20034;21.3
20064451;278996;6;18.04.2024 00:00;63258;54914;8344;6.6
20064450;278995;6;19.04.2024 00:00;14702;14082;620;2.7
20064448;274302;6;19.04.2024 00:00;38600;31680;6920;3.7
20064455;286582;6;19.04.2024 00:00;32300;26752;5548;3.2
20064454;286581;6;19.04.2024 00:00;27244;28160;-916;3.5
20064840;;6;20.04.2024 00:00;0;0;0;0.0
20064449;275092;6;20.04.2024 00:00;7217;681;6536;0.2
20064456;286895;6;20.04.2024 00:00;903;903;0;7.8
20064402;;6;20.04.2024 00:00;0;0;0;0.0
20064457;287074;6;20.04.2024 00:00;65200;50400;14800;6.4
20064452;281411;6;21.04.2024 00:00;108906;104160;4746;12.1
20064453;282463;6;21.04.2024 00:00;221700;204288;17412;23.4
20064857;282846;6;22.04.2024 00:00;57024;51075;5949;5.6
20064489;222339;6;23.04.2024 00:00;27163;21451;5712;2.7
20064542;217841;6;23.04.2024 00:00;66120;62400;3720;7.2
20064544;283928;6;23.04.2024 00:00;5503;5503;0;4.9
20064543;283656;6;24.04.2024 00:00;6724;6724;0;3.2
20064547;281652;6;24.04.2024 00:00;18662;10923;7739;1.5
20064546;276844;6;24.04.2024 00:00;13503;10923;2580;1.5
20064601;286625;6;24.04.2024 00:00;33400;26520;6880;3.5
20064641;274759;6;24.04.2024 00:00;209034;200851;8183;25.1
20064639;273267;6;26.04.2024 00:00;108803;96603;12200;11.7
20064643;285427;6;26.04.2024 00:00;32600;28080;4520;3.2
20064645;285762;6;27.04.2024 00:00;87877;76832;11045;9.0
20064644;285427;6;27.04.2024 00:00;30000;28080;1920;3.2
20064541;;6;27.04.2024 00:00;0;0;0;0.0
20064853;255030;6;27.04.2024 00:00;68923;62101;6822;7.3
20064856;278711;6;28.04.2024 00:00;215392;186914;28478;23.0
20064941;286831;6;29.04.2024 00:00;88702;84372;4330;9.9
20064859;287244;6;30.04.2024 00:00;92677;79554;13123;9.8
20064942;287249;6;30.04.2024 00:00;31002;27106;3896;3.2
20064940;285459;6;01.05.2024 00:00;75556;70754;4802;8.3
20064854;274841;6;01.05.2024 00:00;38183;30979;7204;3.6
20064934;281789;6;01.05.2024 00:00;34702;27842;6860;3.5
20064860;;6;02.05.2024 00:00;0;0;0;0.0
20065044;278612;6;02.05.2024 00:00;60500;51604;8896;6.3
20065574;287585;6;02.05.2024 00:00;34782;34782;0;11.6
20065479;262903;6;03.05.2024 00:00;18204;25804;-7600;2.8
20065043;263463;6;03.05.2024 00:00;96548;78086;18462;11.4
20065089;271183;6;04.05.2024 00:00;131002;100494;30508;12.1
20065122;280400;6;05.05.2024 00:00;257401;204382;53019;23.9
20065378;273863;6;07.05.2024 00:00;68100;53504;14596;6.2
20065377;;6;07.05.2024 00:00;0;0;0;0.0
20065381;282975;6;08.05.2024 00:00;34002;29719;4283;3.5
20065386;287434;6;08.05.2024 00:00;34000;24993;9007;2.8
20065385;287431;6;08.05.2024 00:00;18830;11969;6861;1.4
20065383;287427;6;09.05.2024 00:00;72502;65474;7028;7.4
20065387;287438;6;09.05.2024 00:00;14600;11968;2632;1.5
20065384;287429;6;09.05.2024 00:00;103500;94688;8812;10.9
20065382;285459;6;10.05.2024 00:00;25502;23235;2267;2.6
20065380;281854;6;10.05.2024 00:00;13000;11616;1384;1.3
20065379;274300;6;10.05.2024 00:00;77900;72160;5740;8.5
20065498;278997;6;11.05.2024 00:00;48002;47874;128;5.6
20065496;278993;6;11.05.2024 00:00;19126;12674;6452;1.5
20065497;278996;6;11.05.2024 00:00;13000;12672;328;1.5
20065734;;6;12.05.2024 00:00;0;0;0;0.0
20065198;271516;6;13.05.2024 00:00;545200;502460;42740;58.0
20065901;275509;6;13.05.2024 00:00;26600;26600;0;6.0
20066044;287237;6;16.05.2024 00:00;232372;202344;30028;23.6
20065279;287237;6;16.05.2024 00:00;0;0;0;0.0
20066045;286895;6;17.05.2024 00:00;16410;16410;0;12.0
20065774;;6;17.05.2024 00:00;0;0;0;0.0
20065503;286072;6;17.05.2024 00:00;180500;168960;11540;19.6
20065504;;6;21.05.2024 00:00;0;0;0;0.0
20065709;271621;6;21.05.2024 00:00;121200;112320;8880;12.9
20065756;283870;6;22.05.2024 00:00;62400;51072;11328;5.9
20065757;286343;6;22.05.2024 00:00;32100;25840;6260;3.0
20065755;281863;6;23.05.2024 00:00;60800;53760;7040;6.2
20066041;281502;6;23.05.2024 00:00;110702;100802;9900;11.5
20065864;280125;6;24.05.2024 00:00;57300;55440;1860;6.4
20065867;281926;6;24.05.2024 00:00;64860;51481;13379;6.4
20065863;276844;6;24.05.2024 00:00;22000;20280;1720;2.6
20065865;280716;6;24.05.2024 00:00;33600;26520;7080;3.5
20065868;284959;6;25.05.2024 00:00;14502;10922;3580;1.3
20066092;276951;6;27.05.2024 00:00;7000;6240;760;0.7
20066091;276951;6;27.05.2024 00:00;6440;3120;3320;0.4
20066093;278346;6;27.05.2024 00:00;11400;5071;6329;1.2
20066090;276948;6;27.05.2024 00:00;23200;18720;4480;2.4
20066094;278346;6;27.05.2024 00:00;11000;10140;860;0.8
20066089;276948;6;27.05.2024 00:00;10002;9362;640;1.3
20065861;254369;6;27.05.2024 00:00;76100;70200;5900;9.0
20065962;283084;6;28.05.2024 00:00;59402;50390;9012;6.9
20065961;273260;6;28.05.2024 00:00;123200;117300;5900;15.6
20066031;279138;6;29.05.2024 00:00;34802;27303;7499;3.2
20065607;286781;6;29.05.2024 00:00;27700;27301;399;3.1
20066062;;6;30.05.2024 00:00;0;0;0;0.0
20066035;287326;6;30.05.2024 00:00;6394;6394;0;4.5
20065374;285824;6;30.05.2024 00:00;14782;14782;0;8.5
20066057;;6;30.05.2024 00:00;0;0;0;0.0
20066201;209945;6;30.05.2024 00:00;58000;43456;14544;5.1
20066200;;6;30.05.2024 00:00;0;0;0;0.0
20066202;209946;6;31.05.2024 00:00;51102;40742;10360;4.8
20066204;284914;6;01.06.2024 00:00;53100;43456;9644;5.0
20066203;284906;6;03.06.2024 00:00;56262;47532;8730;6.0
20066222;284911;6;03.06.2024 00:00;52550;44136;8414;5.7
20066223;284915;6;03.06.2024 00:00;56849;46175;10674;5.8
20066388;282335;6;04.06.2024 00:00;33353;29197;4156;3.4
20066328;274300;6;04.06.2024 00:00;31100;22528;8572;2.8
20066387;274302;6;05.06.2024 00:00;24406;25698;-1292;3.2
20066386;274301;6;05.06.2024 00:00;26200;23936;2264;2.7
20066389;287429;6;05.06.2024 00:00;19937;16898;3039;1.8
20066439;278711;6;05.06.2024 00:00;209461;186912;22549;21.4
20066438;255030;6;07.06.2024 00:00;46550;41400;5150;4.9
20066543;284147;6;07.06.2024 00:00;66300;53820;12480;6.0
20066542;271833;6;08.06.2024 00:00;302302;272552;29750;31.6
20066615;275606;6;11.06.2024 00:00;43202;30032;13170;3.6
20066541;;6;11.06.2024 00:00;0;0;0;0.0
20066614;275189;6;12.06.2024 00:00;40902;38612;2290;4.8
20066665;281831;6;12.06.2024 00:00;54000;48360;5640;6.3
20066666;282663;6;12.06.2024 00:00;36402;29642;6760;3.8
20066774;282401;6;13.06.2024 00:00;79800;74880;4920;9.6
20066772;279703;6;13.06.2024 00:00;20602;17942;2660;2.4
20066664;281658;6;13.06.2024 00:00;13602;11702;1900;1.6
20066773;281926;6;13.06.2024 00:00;56102;51482;4620;6.6
20066770;266348;6;14.06.2024 00:00;90600;85800;4800;11.1
20066777;286861;6;14.06.2024 00:00;65100;46801;18299;5.7
20066661;270698;6;17.06.2024 00:00;13000;11648;1352;1.5
20066828;270701;6;17.06.2024 00:00;60450;52416;8034;7.0
20066829;270703;6;17.06.2024 00:00;13000;11648;1352;1.4
20066857;275439;6;17.06.2024 00:00;89050;84448;4602;9.9
20067553;287788;6;18.06.2024 00:00;6300;6300;0;4.0
20066919;277842;6;18.06.2024 00:00;28810;21840;6970;2.8
20066947;276580;6;18.06.2024 00:00;361800;335400;26400;38.6
20067044;287218;6;20.06.2024 00:00;8902;6139;2763;0.8
20067045;287219;6;20.06.2024 00:00;7802;5986;1816;0.7
20067043;283490;6;20.06.2024 00:00;69000;62400;6600;7.3
20066925;287908;6;21.06.2024 00:00;4419;4419;0;4.1
20067041;;6;21.06.2024 00:00;0;0;0;0.0
20067046;287786;6;21.06.2024 00:00;9521;9521;0;3.8
20067042;;6;21.06.2024 00:00;0;0;0;0.0
20067317;287787;6;22.06.2024 00:00;32151;10440;21711;1.3
20067316;286405;6;22.06.2024 00:00;240821;202422;38399;28.5
20067365;273121;6;23.06.2024 00:00;36422;26913;9509;3.2
20067364;273121;6;24.06.2024 00:00;59420;53822;5598;6.5
20067469;273121;6;24.06.2024 00:00;195100;188370;6730;21.6
20067470;275924;6;25.06.2024 00:00;62100;53820;8280;6.4
20067471;278711;6;26.06.2024 00:00;205357;187563;17794;21.5
20067690;287524;6;27.06.2024 00:00;66921;52800;14121;6.1
20067685;276596;6;27.06.2024 00:00;34558;25699;8859;3.1
20067689;285459;6;28.06.2024 00:00;32358;29568;2790;3.6
20067688;285459;6;28.06.2024 00:00;34791;32738;2053;3.7
20067684;275567;6;28.06.2024 00:00;34902;28866;6036;3.3
20067651;284803;6;29.06.2024 00:00;142683;123200;19483;14.9
20067687;278997;6;30.06.2024 00:00;41474;34498;6976;4.1
20067686;278993;6;30.06.2024 00:00;14771;16196;-1425;1.9
20067653;286995;6;30.06.2024 00:00;25859;21731;4128;2.8
20067517;272458;6;30.06.2024 00:00;46848;40744;6104;4.7
20067650;283321;6;01.07.2024 00:00;94600;89628;4972;10.3
20067197;287651;6;01.07.2024 00:00;6812;6812;0;9.0
20067047;;6;02.07.2024 00:00;0;0;0;0.0
20067201;287657;6;02.07.2024 00:00;3170;3170;0;0.5
20067200;287656;6;02.07.2024 00:00;3000;3000;0;1.4
20067203;287659;6;02.07.2024 00:00;3702;3702;0;0.7
20067198;287653;6;02.07.2024 00:00;5690;5690;0;3.3
20067202;287658;6;02.07.2024 00:00;3800;3800;0;0.9
20067199;287655;6;02.07.2024 00:00;3402;3402;0;1.2
20067479;285824;6;02.07.2024 00:00;16409;16409;0;7.6
20067040;287338;6;02.07.2024 00:00;8030;8030;0;6.5
20067196;287650;6;03.07.2024 00:00;5480;5480;0;5.7
20067195;287647;6;03.07.2024 00:00;3220;3220;0;1.2
20067936;;6;03.07.2024 00:00;0;0;0;0.0
20067953;280040;6;03.07.2024 00:00;140500;120912;19588;14.3
20067954;283555;6;04.07.2024 00:00;145002;119342;25660;14.2
20068304;;6;05.07.2024 00:00;0;0;0;0.0
20068306;285824;6;05.07.2024 00:00;9600;9600;0;1.4
20068295;288162;6;05.07.2024 00:00;25972;16174;9798;2.3
20068305;;6;05.07.2024 00:00;0;0;0;0.0
20068298;288167;6;06.07.2024 00:00;33502;30791;2711;4.3
20068297;288166;6;06.07.2024 00:00;13157;7776;5381;1.1
20068299;288168;6;06.07.2024 00:00;11094;7775;3319;1.1
20068296;288165;6;06.07.2024 00:00;36581;30791;5790;3.9
20068294;288086;6;06.07.2024 00:00;77604;69357;8247;9.2
20068289;215474;6;07.07.2024 00:00;20800;18038;2762;2.3
20068292;283670;6;07.07.2024 00:00;90532;79563;10969;9.6
20068796;282971;6;22.07.2024 00:00;59400;59432;-32;6.8
20068797;287893;6;22.07.2024 00:00;32502;28426;4076;3.4
20068745;286848;6;22.07.2024 00:00;24900;23364;1536;2.8
20068749;288070;6;22.07.2024 00:00;3700;1740;1960;0.3
20068748;288027;6;22.07.2024 00:00;10963;10963;0;5.2
20068746;287550;6;23.07.2024 00:00;33500;28513;4987;3.2
20068743;285839;6;23.07.2024 00:00;15100;10912;4188;1.3
20068740;281789;6;23.07.2024 00:00;38402;29878;8524;3.3
20068741;283318;6;24.07.2024 00:00;106900;98455;8445;11.3
20068738;;6;24.07.2024 00:00;0;0;0;0.0
20068742;284877;6;24.07.2024 00:00;46132;32595;13537;3.8
20068747;287728;6;25.07.2024 00:00;38500;33272;5228;3.8
20068737;;6;25.07.2024 00:00;0;0;0;0.0
20068750;288338;6;25.07.2024 00:00;98000;84903;13097;10.4
20068739;275189;6;26.07.2024 00:00;86842;73323;13519;8.6
20069043;288162;6;26.07.2024 00:00;31500;30789;711;3.6
20068751;287375;6;27.07.2024 00:00;51171;46802;4369;6.1
20068753;288336;6;29.07.2024 00:00;29826;20282;9544;2.5
20068752;288327;6;29.07.2024 00:00;25802;22622;3180;2.9
20068830;281926;6;29.07.2024 00:00;118318;112322;5996;15.3
20068922;283838;6;30.07.2024 00:00;15386;10922;4464;1.7
20068921;279780;6;30.07.2024 00:00;19902;17552;2350;2.4
20068923;288233;6;30.07.2024 00:00;8590;8590;0;4.4
20068924;288325;6;30.07.2024 00:00;19802;17162;2640;2.3
20068920;273267;6;31.07.2024 00:00;114840;106606;8234;14.3
20069016;287494;6;02.08.2024 00:00;12400;9360;3040;1.2
20069014;266176;6;02.08.2024 00:00;22600;15211;7389;2.6
20068293;283672;6;02.08.2024 00:00;47300;43681;3619;5.4
20068290;282851;6;03.08.2024 00:00;31403;27219;4184;3.1
20068302;281405;6;05.08.2024 00:00;63502;56114;7388;6.6
20069110;282851;6;05.08.2024 00:00;31300;24192;7108;2.6
20068301;280134;6;05.08.2024 00:00;57500;51409;6091;5.8
20068303;283208;6;05.08.2024 00:00;161000;150529;10471;17.4
20069109;282463;6;06.08.2024 00:00;51400;51072;328;5.9
20069033;;6;07.08.2024 00:00;0;0;0;0.0
20069111;288290;6;07.08.2024 00:00;25560;12090;13470;1.8
20069133;288144;6;07.08.2024 00:00;11733;11733;0;5.0
20069034;;6;08.08.2024 00:00;0;0;0;0.0
20069345;288230;6;08.08.2024 00:00;71440;53821;17619;6.2
20069342;271129;6;08.08.2024 00:00;178300;161460;16840;18.7
20069523;275252;6;09.08.2024 00:00;106352;85563;20789;10.3
20069343;271129;6;09.08.2024 00:00;27002;26912;90;3.0
20069794;287761;6;12.08.2024 00:00;19600;12961;6639;1.5
20069344;287762;6;12.08.2024 00:00;13902;13502;400;1.7
20069341;269065;6;12.08.2024 00:00;22300;10865;11435;1.4
20069340;240525;6;12.08.2024 00:00;49902;42100;7802;5.0
20068950;287651;6;13.08.2024 00:00;7023;7023;0;4.0
20069386;271845;6;13.08.2024 00:00;36700;24444;12256;2.8
20069387;280659;6;13.08.2024 00:00;63052;52285;10767;6.2
20069394;288169;6;14.08.2024 00:00;82672;76034;6638;8.8
20069395;288428;6;14.08.2024 00:00;83652;74978;8674;8.8
20069391;287431;6;15.08.2024 00:00;22000;19360;2640;2.2
20069389;287427;6;15.08.2024 00:00;41900;29568;12332;3.4
20069390;287429;6;15.08.2024 00:00;59102;29570;29532;3.5
20069393;287524;6;16.08.2024 00:00;29802;27811;1991;3.3
20069388;287244;6;16.08.2024 00:00;35602;33794;1808;4.1
20069392;287438;6;16.08.2024 00:00;12502;10562;1940;1.3
20069820;;6;16.08.2024 00:00;0;0;0;0.0
20069705;285551;6;16.08.2024 00:00;56602;36389;20213;4.4
20069708;287738;6;17.08.2024 00:00;37297;24962;12335;3.4
20069699;281821;6;17.08.2024 00:00;37900;26880;11020;3.2
20069697;281378;6;19.08.2024 00:00;58402;50066;8336;6.1
20069701;283870;6;19.08.2024 00:00;60602;53762;6840;6.3
20069698;281411;6;20.08.2024 00:00;35200;33600;1600;3.9
20069703;284584;6;20.08.2024 00:00;97202;86192;11010;10.4
20069709;288085;6;20.08.2024 00:00;25800;22231;3569;2.5
20069707;287018;6;21.08.2024 00:00;33225;27304;5921;3.2
20069706;285762;6;21.08.2024 00:00;92400;82290;10110;9.9
20069704;285427;6;22.08.2024 00:00;35932;28080;7852;3.6
20069710;288528;6;22.08.2024 00:00;70603;63183;7420;7.4
20069984;;6;22.08.2024 00:00;0;0;0;0.0
20069986;286577;6;23.08.2024 00:00;68972;56262;12710;7.0
20069985;286404;6;23.08.2024 00:00;30252;26682;3570;3.0
20069988;287787;6;23.08.2024 00:00;29902;26682;3220;3.1
20069987;286997;6;24.08.2024 00:00;155605;140940;14665;17.2
20070067;269490;6;24.08.2024 00:00;43199;29571;13628;3.8
20069992;288664;6;25.08.2024 00:00;25056;17955;7101;2.2
20069993;288665;6;25.08.2024 00:00;24816;21122;3694;2.7
20069990;288660;6;25.08.2024 00:00;25470;22177;3293;2.5
20069989;288654;6;25.08.2024 00:00;32595;22528;10067;2.9
20069991;288662;6;26.08.2024 00:00;33937;29571;4366;3.5
20069994;288667;6;26.08.2024 00:00;25674;22176;3498;2.6
20070153;287431;6;26.08.2024 00:00;23100;19008;4092;2.2
20070154;287438;6;26.08.2024 00:00;14502;12674;1828;1.4
20070151;287244;6;26.08.2024 00:00;76523;76034;489;8.6
20070152;287429;6;27.08.2024 00:00;101436;97858;3578;11.8
20070156;287249;6;27.08.2024 00:00;10400;11968;-1568;1.4
20070071;278995;6;27.08.2024 00:00;40612;24290;16322;2.7
20070422;283408;6;28.08.2024 00:00;23802;21122;2680;2.5
20070072;281929;6;28.08.2024 00:00;38700;31153;7547;3.6
20070069;271845;6;28.08.2024 00:00;29198;24447;4751;2.9
20070073;288154;6;29.08.2024 00:00;27851;20122;7729;2.4
20070150;275999;6;29.08.2024 00:00;38500;25921;12579;2.9
20069821;;6;29.08.2024 00:00;0;0;0;0.0
20069032;287766;6;29.08.2024 00:00;10848;10848;0;8.0
20070434;288534;6;30.08.2024 00:00;163038;147290;15748;17.1
20070197;;6;30.08.2024 00:00;0;0;0;0.0
20070435;288534;6;31.08.2024 00:00;118217;113698;4519;14.0
20070198;288535;6;01.09.2024 00:00;505952;478365;27587;64.4
20070436;288535;6;04.09.2024 00:00;233626;220932;12694;29.9
20070201;288454;6;05.09.2024 00:00;84274;79560;4714;10.6
20070203;288456;6;05.09.2024 00:00;211000;193358;17642;26.5
20070202;288455;6;07.09.2024 00:00;172512;161070;11442;22.2
20070433;283928;6;08.09.2024 00:00;17390;17390;0;4.0
20070431;270707;6;08.09.2024 00:00;50264;40769;9495;4.6
20070432;283656;6;08.09.2024 00:00;10838;10838;0;1.5
20070467;270702;6;09.09.2024 00:00;51000;42225;8775;4.9
20070469;270704;6;09.09.2024 00:00;23187;19659;3528;2.3
20070468;270703;6;09.09.2024 00:00;14502;10558;3944;1.2
20070596;288578;6;09.09.2024 00:00;10660;5611;5049;0.6
20070591;249580;6;10.09.2024 00:00;29900;24570;5330;3.2
20070592;268719;6;10.09.2024 00:00;33662;28863;4799;3.6
20070444;;6;10.09.2024 00:00;0;0;0;0.0
20070593;271183;6;11.09.2024 00:00;165300;135800;29500;16.0
20070595;280400;6;12.09.2024 00:00;362000;325920;36080;38.8
20070736;271516;6;14.09.2024 00:00;453170;404684;48486;48.2
20070840;;6;16.09.2024 00:00;0;0;0;0.0
20070756;268269;6;16.09.2024 00:00;64830;57960;6870;8.5
20070757;278711;6;17.09.2024 00:00;213302;186914;26388;21.7
20070835;278711;6;18.09.2024 00:00;217848;210278;7570;24.8
20070896;278711;6;19.09.2024 00:00;196096;186912;9184;22.2
20070989;285686;6;20.09.2024 00:00;73952;63150;10802;7.5
20070992;286831;6;20.09.2024 00:00;39618;39618;0;3.4
20070991;286405;6;23.09.2024 00:00;454102;417602;36500;48.9
20071090;287763;6;26.09.2024 00:00;7603;3;7600;7.5
20071265;284942;6;26.09.2024 00:00;45850;37423;8427;4.6
20071263;;6;26.09.2024 00:00;0;0;0;0.0
20071313;288888;6;27.09.2024 00:00;62892;44072;18820;6.1
20071307;281821;6;27.09.2024 00:00;36000;27216;8784;3.3
20071310;286220;6;30.09.2024 00:00;33620;26880;6740;3.2
20071311;286986;6;30.09.2024 00:00;109902;98114;11788;11.8
20071356;281383;6;30.09.2024 00:00;56500;53761;2739;6.4
20071433;281378;6;01.10.2024 00:00;103302;96770;6532;11.7
20071309;283670;6;01.10.2024 00:00;48000;43680;4320;5.0
20071432;280125;6;01.10.2024 00:00;86902;75602;11300;9.0
20071423;285762;6;02.10.2024 00:00;89600;81120;8480;10.0
20071487;;6;03.10.2024 00:00;0;0;0;0.0
20071618;289042;6;03.10.2024 00:00;5502;5502;0;10.7
20071424;288965;6;04.10.2024 00:00;6600;2341;4259;0.3
20071425;288967;6;04.10.2024 00:00;5500;2340;3160;0.3
20071490;288833;6;04.10.2024 00:00;7377;7377;0;5.4
20071489;288809;6;04.10.2024 00:00;6878;6878;0;6.9
20071422;;6;05.10.2024 00:00;0;0;0;0.0
20071507;287728;6;05.10.2024 00:00;44011;30559;13452;3.6
20071508;288812;6;06.10.2024 00:00;13149;2719;10430;0.3
20071534;277007;6;06.10.2024 00:00;109525;80730;28795;10.4
20071888;;6;06.10.2024 00:00;0;0;0;0.0
20071535;277007;6;07.10.2024 00:00;57602;53822;3780;6.6
20071533;275252;6;07.10.2024 00:00;60300;53820;6480;6.4
20071532;272443;6;07.10.2024 00:00;30250;22771;7479;2.6
20071557;278711;6;08.10.2024 00:00;215102;187563;27539;22.1
20071806;270508;6;09.10.2024 00:00;83450;81125;2325;9.7
20072201;275509;6;10.10.2024 00:00;9650;9650;0;5.7
20071822;288723;6;10.10.2024 00:00;58900;48929;9971;6.5
20071818;287438;6;10.10.2024 00:00;20000;13377;6623;1.5
20071816;287429;6;11.10.2024 00:00;47002;44706;2296;5.5
20071815;287427;6;11.10.2024 00:00;18000;16544;1456;2.0
20071817;287431;6;11.10.2024 00:00;14000;12320;1680;1.7
20071814;287244;6;11.10.2024 00:00;72600;69696;2904;8.6
20071821;288662;6;11.10.2024 00:00;23000;21121;1879;2.7
20071516;287766;6;12.10.2024 00:00;8892;8892;0;6.5
20071505;;6;12.10.2024 00:00;0;0;0;0.0
20071820;288654;6;12.10.2024 00:00;12937;10912;2025;1.5
20071887;;6;14.10.2024 00:00;0;0;0;0.0
20071812;285839;6;14.10.2024 00:00;12000;10912;1088;1.2
20071813;286582;6;14.10.2024 00:00;25355;16898;8457;2.2
20071811;284803;6;14.10.2024 00:00;112547;100672;11875;12.0
20071810;278997;6;15.10.2024 00:00;38752;31682;7070;3.9
20071807;274302;6;15.10.2024 00:00;11300;14784;-3484;1.8
20071808;278994;6;15.10.2024 00:00;31322;29570;1752;3.6
20071809;278995;6;15.10.2024 00:00;19332;16898;2434;2.2
20071819;288169;6;16.10.2024 00:00;30704;30275;429;3.8
20072206;288924;6;16.10.2024 00:00;4799;2817;1982;3.0
20071805;;6;16.10.2024 00:00;0;0;0;0.0
20072205;288290;6;16.10.2024 00:00;21431;12873;8558;1.5
20072227;;6;16.10.2024 00:00;0;0;0;0.0
20072208;273260;6;17.10.2024 00:00;60000;48300;11700;6.5
20072207;289003;6;17.10.2024 00:00;25702;19383;6319;2.7
20072218;289000;6;17.10.2024 00:00;45152;40054;5098;5.6
20072219;289004;6;18.10.2024 00:00;37565;25842;11723;3.6
20072275;288739;6;18.10.2024 00:00;3135;3135;0;2.0
20072325;288535;6;18.10.2024 00:00;114450;108529;5921;15.3
20072215;286625;6;21.10.2024 00:00;19902;10923;8979;1.5
20072217;288336;6;21.10.2024 00:00;19002;16382;2620;2.1
20072214;281926;6;21.10.2024 00:00;115650;112320;3330;15.6
20072212;279877;6;22.10.2024 00:00;40802;30422;10380;4.2
20072213;281420;6;22.10.2024 00:00;27902;28472;-570;4.0
20072209;276848;6;23.10.2024 00:00;38202;31202;7000;4.3
20072210;279702;6;23.10.2024 00:00;23000;21840;1160;3.0
20072457;279879;6;23.10.2024 00:00;36902;31202;5700;4.4
20072211;279769;6;23.10.2024 00:00;12502;10922;1580;1.6
20072216;287353;6;23.10.2024 00:00;13802;10922;2880;1.5
20072271;281565;6;23.10.2024 00:00;12800;10530;2270;1.4
20072272;283332;6;23.10.2024 00:00;12502;10142;2360;1.4
20072236;282197;6;24.10.2024 00:00;14302;14042;260;2.0
20072237;284219;6;24.10.2024 00:00;36000;34710;1290;4.8
20072238;288599;6;24.10.2024 00:00;71504;67084;4420;9.3
20072235;281658;6;24.10.2024 00:00;12300;10920;1380;1.5
20072270;276844;6;24.10.2024 00:00;22400;22230;170;3.1
20072273;284802;6;24.10.2024 00:00;12302;10922;1380;1.6
20072289;288817;6;25.10.2024 00:00;26602;13064;13538;1.6
20072326;288326;6;25.10.2024 00:00;29300;27690;1610;3.8
20072327;288534;6;25.10.2024 00:00;112225;100776;11449;12.2
20071823;281411;6;26.10.2024 00:00;117404;105842;11562;11.6
20071824;286986;6;27.10.2024 00:00;111980;96768;15212;11.9
20072472;282463;6;28.10.2024 00:00;163102;156242;6860;18.3
20072675;283672;6;28.10.2024 00:00;46300;37441;8859;4.8
20072588;;6;29.10.2024 00:00;0;0;0;0.0
20072596;289033;6;29.10.2024 00:00;103787;74524;29263;9.7
20072598;289156;6;30.10.2024 00:00;66492;60480;6012;7.9
20072595;288970;6;31.10.2024 00:00;42363;29200;13163;3.8
20072589;;6;31.10.2024 00:00;0;0;0;0.0
20072597;289091;6;31.10.2024 00:00;20400;15120;5280;2.0
20072590;274300;6;31.10.2024 00:00;96939;84480;12459;10.2
20072592;287249;6;01.11.2024 00:00;32130;22880;9250;3.3
20072591;278993;6;01.11.2024 00:00;16000;11616;4384;1.6
20072594;288667;6;01.11.2024 00:00;29820;26753;3067;3.5
20072593;287429;6;01.11.2024 00:00;35000;33088;1912;4.2
20072690;289129;6;02.11.2024 00:00;25600;25696;-96;3.3
20072956;282454;6;02.11.2024 00:00;36415;22530;13885;3.0
20072642;289112;6;02.11.2024 00:00;26137;10865;15272;1.4
20072641;289111;6;03.11.2024 00:00;10039;10866;-827;1.4
20072640;289110;6;03.11.2024 00:00;28318;27162;1156;3.4
20072688;268269;6;03.11.2024 00:00;87014;57271;29743;9.9
20072687;266011;6;04.11.2024 00:00;127176;107640;19536;14.5
20072689;277007;6;05.11.2024 00:00;158840;142830;16010;17.7
20072803;288960;6;05.11.2024 00:00;44461;32592;11869;3.9
20072808;288963;6;06.11.2024 00:00;33828;33952;-124;4.1
20072806;288961;6;07.11.2024 00:00;39748;32592;7156;3.9
20072807;288962;6;07.11.2024 00:00;33426;32592;834;3.9
20072801;259701;6;07.11.2024 00:00;14000;10864;3136;1.3
20072916;278711;6;07.11.2024 00:00;395209;373826;21383;45.2
20072800;259700;6;07.11.2024 00:00;11000;10864;136;1.5
20072955;271516;6;10.11.2024 00:00;414093;350364;63729;42.6
20072917;;6;10.11.2024 00:00;0;0;0;0.0
20073002;288775;6;12.11.2024 00:00;539000;507892;31108;60.3
20073254;;6;15.11.2024 00:00;0;0;0;0.0
20073267;275189;6;15.11.2024 00:00;42586;39000;3586;4.7
20073272;288338;6;16.11.2024 00:00;161912;138397;23515;18.4
20073268;288086;6;17.11.2024 00:00;91550;84592;6958;10.9
20073270;288166;6;17.11.2024 00:00;17210;15550;1660;2.2
20073271;288167;6;17.11.2024 00:00;16120;15550;570;2.0
20041265;282282;7;04.01.2023 00:00;20018;20018;0;1.6
20041271;;7;04.01.2023 00:00;0;0;0;0.0
20041266;282297;7;04.01.2023 00:00;20162;20162;0;1.6
20041268;282327;7;05.01.2023 00:00;21840;21840;0;1.8
20043224;282297;7;05.01.2023 00:00;20160;20160;0;1.6
20043169;270324;7;05.01.2023 00:00;31702;28226;3476;2.4
20043159;270339;7;05.01.2023 00:00;19661;17136;2525;1.5
20043165;279156;7;06.01.2023 00:00;174228;150771;23457;12.8
20043174;273717;7;06.01.2023 00:00;2018;2018;0;2.6
20043170;271168;7;06.01.2023 00:00;44280;43634;646;4.3
20043162;274684;7;07.01.2023 00:00;34002;28226;5776;2.4
20043161;273165;7;07.01.2023 00:00;19918;19443;475;1.8
20043163;275068;7;07.01.2023 00:00;50000;48384;1616;4.4
20043166;279717;7;07.01.2023 00:00;35046;20739;14307;1.9
20043160;271548;7;07.01.2023 00:00;26002;20738;5264;2.0
20043164;275360;7;08.01.2023 00:00;93042;81792;11250;7.9
20043206;279135;7;08.01.2023 00:00;45121;44352;769;3.8
20041270;;7;08.01.2023 00:00;0;0;0;0.0
20041272;282320;7;09.01.2023 00:00;21056;21056;0;1.7
20041434;282310;7;09.01.2023 00:00;21282;21282;0;1.6
20041262;282270;7;09.01.2023 00:00;20088;20088;0;1.6
20043430;282270;7;10.01.2023 00:00;21054;21054;0;1.7
20043419;282310;7;10.01.2023 00:00;22344;22344;0;2.0
20041269;;7;10.01.2023 00:00;0;0;0;0.0
20043378;274163;7;10.01.2023 00:00;392203;339842;52361;30.2
20043379;277970;7;12.01.2023 00:00;91395;80643;10752;7.9
20043381;271542;7;13.01.2023 00:00;68138;57604;10534;4.9
20043397;276134;7;13.01.2023 00:00;31440;25920;5520;2.9
20043380;269694;7;13.01.2023 00:00;78791;63362;15429;6.2
20043382;271543;7;14.01.2023 00:00;37013;31107;5906;2.8
20043390;273553;7;14.01.2023 00:00;165891;148610;17281;13.1
20043389;272810;7;15.01.2023 00:00;28810;24195;4615;2.3
20043388;272799;7;15.01.2023 00:00;35820;34560;1260;3.1
20043395;275765;7;15.01.2023 00:00;53482;48384;5098;4.1
20043392;274101;7;15.01.2023 00:00;210080;193538;16542;16.9
20043391;273568;7;16.01.2023 00:00;105829;96770;9059;8.4
20043393;275066;7;16.01.2023 00:00;22677;20162;2515;1.7
20043383;271673;7;17.01.2023 00:00;22682;20162;2520;1.7
20043400;279136;7;17.01.2023 00:00;52760;48384;4376;4.1
20043385;271988;7;17.01.2023 00:00;28021;24195;3826;2.2
20043384;271673;7;17.01.2023 00:00;25002;24194;808;2.2
20043401;281665;7;17.01.2023 00:00;34862;28226;6636;2.6
20043399;278287;7;17.01.2023 00:00;78538;72583;5955;6.3
20043386;272189;7;17.01.2023 00:00;61949;52418;9531;4.7
20043394;275372;7;18.01.2023 00:00;485208;461952;23256;38.3
20043410;275372;7;20.01.2023 00:00;217482;205634;11848;16.9
20043402;282124;7;20.01.2023 00:00;59375;52416;6959;4.7
20043944;275765;7;21.01.2023 00:00;55700;48384;7316;4.4
20043995;276362;7;21.01.2023 00:00;238452;221762;16690;18.6
20043945;275877;7;22.01.2023 00:00;230396;221762;8634;18.4
20043943;272625;7;23.01.2023 00:00;26116;24194;1922;2.1
20043948;280466;7;23.01.2023 00:00;108291;92594;15697;9.1
20043947;280465;7;23.01.2023 00:00;218697;198722;19975;17.4
20044042;273756;7;24.01.2023 00:00;49764;42483;7281;3.7
20044041;273417;7;25.01.2023 00:00;54286;48960;5326;4.1
20044039;273020;7;25.01.2023 00:00;30431;24192;6239;2.3
20044044;278877;7;25.01.2023 00:00;29895;25488;4407;2.3
20044046;279696;7;25.01.2023 00:00;24920;17280;7640;1.5
20044037;270325;7;25.01.2023 00:00;36990;32259;4731;2.7
20044038;272829;7;25.01.2023 00:00;11380;10370;1010;1.0
20044040;273165;7;26.01.2023 00:00;14530;13538;992;1.2
20044047;281240;7;26.01.2023 00:00;30240;30240;0;5.4
20044043;275360;7;26.01.2023 00:00;51087;41474;9613;4.2
20044045;279144;7;26.01.2023 00:00;217275;200452;16823;16.4
20044114;270339;7;27.01.2023 00:00;51704;48387;3317;3.9
20044117;279019;7;27.01.2023 00:00;54012;48386;5626;3.9
20044116;275073;7;28.01.2023 00:00;137290;124704;12586;10.3
20044115;272565;7;28.01.2023 00:00;137174;124564;12610;10.2
20044378;273166;7;29.01.2023 00:00;207050;197424;9626;15.7
20044127;275764;7;29.01.2023 00:00;25940;24192;1748;2.1
20044126;275069;7;30.01.2023 00:00;35892;28226;7666;2.3
20044426;272054;7;30.01.2023 00:00;310332;290306;20026;23.5
20044430;281636;7;31.01.2023 00:00;80492;72002;8490;6.0
20044124;264700;7;31.01.2023 00:00;86003;73729;12274;6.4
20044427;271168;7;31.01.2023 00:00;48499;48098;401;3.9
20044486;270324;7;01.02.2023 00:00;16337;11522;4815;1.1
20044488;276316;7;01.02.2023 00:00;44506;40034;4472;3.4
20044480;281608;7;01.02.2023 00:00;281664;250995;30669;15.8
20044479;274101;7;02.02.2023 00:00;481445;443378;38067;37.9
20044671;276322;7;04.02.2023 00:00;121942;100802;21140;10.3
20044803;275509;7;04.02.2023 00:00;0;0;0;0.0
20044672;277492;7;05.02.2023 00:00;109170;96770;12400;8.4
20044886;275372;7;05.02.2023 00:00;51517;48384;3133;4.3
20044885;273568;7;06.02.2023 00:00;53808;48386;5422;4.3
20044884;272810;7;06.02.2023 00:00;27729;24192;3537;2.2
20044926;277970;7;06.02.2023 00:00;94107;83522;10585;7.3
20044927;274163;7;06.02.2023 00:00;514537;478082;36455;42.5
20044928;274587;7;08.02.2023 00:00;33056;28802;4254;2.5
20044934;281606;7;09.02.2023 00:00;59581;49537;10044;4.6
20044881;273290;7;09.02.2023 00:00;46312;44642;1670;3.6
20044933;279158;7;09.02.2023 00:00;40022;34560;5462;3.1
20044932;272190;7;09.02.2023 00:00;34560;31104;3456;2.7
20045013;273248;7;10.02.2023 00:00;19692;17282;2410;1.6
20045015;277485;7;10.02.2023 00:00;112880;100224;12656;9.3
20045011;271952;7;10.02.2023 00:00;20327;17282;3045;1.6
20045012;272075;7;10.02.2023 00:00;173290;162432;10858;14.2
20045014;274103;7;11.02.2023 00:00;139453;131330;8123;12.3
20045016;278654;7;11.02.2023 00:00;28961;24194;4767;2.3
20045082;275765;7;12.02.2023 00:00;100863;96770;4093;8.6
20045084;277192;7;12.02.2023 00:00;28565;24192;4373;2.3
20045081;274686;7;12.02.2023 00:00;26387;24194;2193;1.9
20045080;272878;7;12.02.2023 00:00;28482;24194;4288;2.2
20045083;276576;7;12.02.2023 00:00;24810;24192;618;2.2
20045085;275071;7;13.02.2023 00:00;48752;48242;510;4.4
20045131;272010;7;13.02.2023 00:00;30032;24192;5840;2.6
20045146;275372;7;13.02.2023 00:00;105867;83521;22346;8.5
20045132;272189;7;13.02.2023 00:00;54118;48384;5734;4.1
20045147;275372;7;14.02.2023 00:00;383762;360005;23757;32.2
20045373;275877;7;16.02.2023 00:00;324288;294336;29952;27.1
20045369;271988;7;18.02.2023 00:00;27232;24194;3038;2.8
20045371;275066;7;18.02.2023 00:00;32312;24192;8120;3.1
20045372;275765;7;20.02.2023 00:00;58145;52418;5727;4.9
20045377;281665;7;20.02.2023 00:00;24132;24194;-62;2.1
20045130;267387;7;20.02.2023 00:00;53508;43058;10450;3.6
20045145;275360;7;20.02.2023 00:00;103298;87552;15746;8.3
20045378;275070;7;21.02.2023 00:00;24478;20739;3739;2.0
20045379;279717;7;21.02.2023 00:00;47900;44784;3116;4.0
20045380;272565;7;21.02.2023 00:00;64546;52416;12130;4.4
20045385;282974;7;21.02.2023 00:00;5186;5186;0;2.3
20045384;282970;7;21.02.2023 00:00;17282;17282;0;2.1
20045764;281636;7;22.02.2023 00:00;160471;150483;9988;12.8
20045382;274523;7;22.02.2023 00:00;37065;32256;4809;2.7
20045415;;7;22.02.2023 00:00;0;0;0;0.0
20045420;271984;7;23.02.2023 00:00;30154;16130;14024;1.5
20045419;266891;7;23.02.2023 00:00;22325;17281;5044;1.4
20045611;274391;7;23.02.2023 00:00;41698;40322;1376;3.4
20045425;279088;7;23.02.2023 00:00;24613;21027;3586;1.9
20045424;275658;7;23.02.2023 00:00;12729;10658;2071;1.0
20045610;271739;7;23.02.2023 00:00;39002;37154;1848;3.3
20045426;280407;7;24.02.2023 00:00;14702;10946;3756;1.0
20045586;279087;7;24.02.2023 00:00;48371;37872;10499;3.6
20045422;274390;7;24.02.2023 00:00;130063;124418;5645;10.6
20045423;275221;7;24.02.2023 00:00;60800;51843;8957;4.4
20045421;272643;7;25.02.2023 00:00;120042;96770;23272;8.8
20045583;273151;7;27.02.2023 00:00;19540;10369;9171;1.0
20045581;271741;7;27.02.2023 00:00;31373;27650;3723;2.3
20045584;274458;7;27.02.2023 00:00;31756;27504;4252;2.5
20045582;271741;7;27.02.2023 00:00;37287;34562;2725;2.8
20045600;;7;28.02.2023 00:00;0;0;0;0.0
20045585;278243;7;28.02.2023 00:00;45172;41474;3698;3.4
20045845;281606;7;28.02.2023 00:00;214305;196706;17599;17.8
20045841;274586;7;01.03.2023 00:00;41834;32546;9288;3.1
20045839;271542;7;01.03.2023 00:00;40086;25922;14164;2.5
20045838;269694;7;01.03.2023 00:00;48176;43200;4976;4.4
20045842;275075;7;02.03.2023 00:00;88612;77762;10850;7.5
20045840;274163;7;02.03.2023 00:00;272868;244802;28066;22.6
20046125;281608;7;03.03.2023 00:00;459294;427395;31899;40.1
20046124;275372;7;07.03.2023 00:00;304448;279793;24655;25.6
20046478;274101;7;09.03.2023 00:00;316507;293908;22599;26.8
20046225;275071;7;09.03.2023 00:00;60542;52418;8124;4.9
20047017;275877;7;11.03.2023 00:00;209108;194690;14418;17.0
20046226;272190;7;12.03.2023 00:00;38551;30243;8308;2.8
20046227;273553;7;13.03.2023 00:00;15591;12674;2917;1.1
20047025;274103;7;13.03.2023 00:00;105380;96771;8609;9.3
20046551;279156;7;13.03.2023 00:00;280426;249986;30440;20.9
20047016;274523;7;15.03.2023 00:00;79686;68544;11142;5.8
20046553;280373;7;15.03.2023 00:00;113904;76610;37294;8.4
20046544;271168;7;15.03.2023 00:00;29020;20162;8858;1.6
20046552;279405;7;16.03.2023 00:00;26395;26210;185;2.1
20046560;283447;7;16.03.2023 00:00;40527;28226;12301;2.4
20046556;281644;7;16.03.2023 00:00;33969;28226;5743;2.3
20046548;275069;7;16.03.2023 00:00;27890;24192;3698;2.1
20046667;272887;7;16.03.2023 00:00;23172;20162;3010;1.6
20046558;282278;7;16.03.2023 00:00;56556;52418;4138;4.3
20046668;277213;7;17.03.2023 00:00;28373;21171;7202;2.0
20046550;279144;7;17.03.2023 00:00;98456;53136;45320;5.7
20047015;270324;7;17.03.2023 00:00;26182;21170;5012;2.1
20047022;274518;7;18.03.2023 00:00;128440;88993;39447;9.3
20046554;280465;7;20.03.2023 00:00;56580;54720;1860;4.8
20046555;280466;7;21.03.2023 00:00;52171;44354;7817;3.9
20047187;271610;7;21.03.2023 00:00;4257;4034;223;0.4
20046542;267717;7;21.03.2023 00:00;39328;25059;14269;2.4
20046549;279135;7;21.03.2023 00:00;23830;16128;7702;1.5
20046546;273917;7;22.03.2023 00:00;21190;20736;454;1.9
20046543;270325;7;22.03.2023 00:00;41156;31826;9330;2.9
20047018;281240;7;22.03.2023 00:00;20302;20302;0;3.4
20047440;275068;7;22.03.2023 00:00;33119;24194;8925;2.2
20047439;274684;7;22.03.2023 00:00;27346;25346;2000;2.3
20047188;283627;7;22.03.2023 00:00;226265;175680;50585;17.4
20047443;275075;7;24.03.2023 00:00;89680;66240;23440;6.1
20047430;269694;7;25.03.2023 00:00;44414;43202;1212;4.0
20047437;274163;7;25.03.2023 00:00;164202;144002;20200;14.3
20047918;273553;7;26.03.2023 00:00;98347;82946;15401;7.7
20047919;271543;7;27.03.2023 00:00;42857;38018;4839;3.7
20047444;276306;7;27.03.2023 00:00;26713;20736;5977;1.8
20047434;272799;7;27.03.2023 00:00;36600;34560;2040;3.0
20047429;267387;7;27.03.2023 00:00;78917;61634;17283;6.1
20048010;275071;7;28.03.2023 00:00;78062;68544;9518;6.3
20047433;272054;7;28.03.2023 00:00;53710;44354;9356;3.7
20047448;280122;7;28.03.2023 00:00;31485;25202;6283;2.2
20047449;282215;7;29.03.2023 00:00;32347;28226;4121;1.6
20047442;275073;7;29.03.2023 00:00;24446;20162;4284;1.7
20047446;279019;7;29.03.2023 00:00;48554;44354;4200;3.6
20047447;279144;7;29.03.2023 00:00;38258;27074;11184;2.3
20047445;276316;7;29.03.2023 00:00;22765;20162;2603;1.8
20047451;283626;7;30.03.2023 00:00;190088;158258;31830;15.0
20047431;270339;7;30.03.2023 00:00;39375;35714;3661;3.1
20047820;268794;7;31.03.2023 00:00;26860;20160;6700;1.9
20048011;283180;7;31.03.2023 00:00;311715;274178;37537;24.9
20047435;273020;7;03.04.2023 00:00;31905;25202;6703;2.4
20047450;283545;7;03.04.2023 00:00;73939;51840;22099;4.8
20048354;274586;7;04.04.2023 00:00;29937;20739;9198;1.9
20047436;273246;7;04.04.2023 00:00;19410;17280;2130;1.4
20048190;272190;7;04.04.2023 00:00;41363;34704;6659;3.5
20048189;271952;7;04.04.2023 00:00;36849;31104;5745;3.1
20048428;277485;7;04.04.2023 00:00;71509;62210;9299;6.3
20048356;274103;7;05.04.2023 00:00;60542;53282;7260;5.2
20048355;273568;7;05.04.2023 00:00;66207;52416;13791;5.2
20048193;276576;7;05.04.2023 00:00;55001;48384;6617;4.8
20048194;279136;7;06.04.2023 00:00;84234;72578;11656;6.7
20048359;278654;7;06.04.2023 00:00;37126;24195;12931;2.7
20048358;274686;7;11.04.2023 00:00;29630;24194;5436;2.3
20048424;271673;7;11.04.2023 00:00;27506;24192;3314;2.4
20048585;277492;7;11.04.2023 00:00;81095;72578;8517;7.0
20048425;272189;7;12.04.2023 00:00;61595;49394;12201;5.0
20048485;274198;7;12.04.2023 00:00;28746;24194;4552;2.8
20048642;276362;7;12.04.2023 00:00;108254;96771;11483;9.5
20048712;274103;7;13.04.2023 00:00;68655;51554;17101;5.2
20048577;279032;7;13.04.2023 00:00;29849;11520;18329;2.7
20048569;270325;7;13.04.2023 00:00;60173;50691;9482;5.2
20048578;283742;7;14.04.2023 00:00;67540;57602;9938;5.2
20048580;283846;7;14.04.2023 00:00;211918;174673;37245;16.7
20048575;277974;7;17.04.2023 00:00;84240;66240;18000;7.2
20048573;277974;7;18.04.2023 00:00;144748;120962;23786;12.0
20048572;277974;7;19.04.2023 00:00;131853;120962;10891;11.3
20048574;277974;7;19.04.2023 00:00;130712;120962;9750;10.8
20048931;283180;7;20.04.2023 00:00;173044;157250;15794;13.5
20048929;275068;7;20.04.2023 00:00;31226;22898;8328;2.2
20048930;275073;7;21.04.2023 00:00;53400;44354;9046;3.7
20048576;279019;7;21.04.2023 00:00;51581;48386;3195;4.1
20048579;283822;7;21.04.2023 00:00;31002;28226;2776;2.4
20048581;283848;7;21.04.2023 00:00;162002;151778;10224;12.4
20049395;274523;7;24.04.2023 00:00;89148;74307;14841;6.6
20048940;272054;7;24.04.2023 00:00;114182;93890;20292;8.3
20049397;279144;7;25.04.2023 00:00;201637;174243;27394;15.3
20049092;275877;7;26.04.2023 00:00;273845;245954;27891;21.2
20048939;270324;7;26.04.2023 00:00;30251;25634;4617;2.2
20049285;272289;7;27.04.2023 00:00;140473;133058;7415;11.3
20049396;275765;7;28.04.2023 00:00;219520;193536;25984;16.4
20049485;280159;7;29.04.2023 00:00;195277;181442;13835;15.5
20049484;280159;7;01.05.2023 00:00;187552;181442;6110;15.9
20049486;280159;7;02.05.2023 00:00;209385;181440;27945;16.3
20049488;280159;7;03.05.2023 00:00;195632;181442;14190;15.9
20049487;280159;7;04.05.2023 00:00;192810;181442;11368;16.0
20049905;275877;7;05.05.2023 00:00;111848;100802;11046;8.8
20049678;277970;7;05.05.2023 00:00;173012;146883;26129;13.5
20049429;279158;7;08.05.2023 00:00;22383;17280;5103;1.6
20049428;271952;7;08.05.2023 00:00;22421;18434;3987;1.6
20049724;280160;7;08.05.2023 00:00;133832;120962;12870;10.6
20049725;280160;7;09.05.2023 00:00;123312;120962;2350;10.7
20049726;280465;7;09.05.2023 00:00;125818;109445;16373;10.0
20049466;280466;7;10.05.2023 00:00;227012;197571;29441;17.0
20049877;277270;7;11.05.2023 00:00;108828;100802;8026;8.9
20050209;284073;7;11.05.2023 00:00;33552;29810;3742;2.6
20049878;284049;7;12.05.2023 00:00;381367;346464;34903;30.1
20050042;284050;7;13.05.2023 00:00;86621;76610;10011;7.3
20050034;272565;7;14.05.2023 00:00;65370;64514;856;5.5
20050036;275062;7;14.05.2023 00:00;34363;28226;6137;2.6
20050352;273010;7;14.05.2023 00:00;59800;48385;11415;4.7
20050039;279156;7;14.05.2023 00:00;166776;142848;23928;13.0
20050041;283848;7;15.05.2023 00:00;26002;23762;2240;2.0
20050334;283530;7;15.05.2023 00:00;119873;101522;18351;9.0
20050031;270324;7;16.05.2023 00:00;23911;11522;12389;1.9
20050038;276134;7;16.05.2023 00:00;16596;14403;2193;1.4
20050035;273290;7;16.05.2023 00:00;18812;11522;7290;1.0
20050033;272008;7;17.05.2023 00:00;18672;14402;4270;1.4
20050037;275075;7;17.05.2023 00:00;58132;55872;2260;5.4
20050032;271542;7;17.05.2023 00:00;18952;14402;4550;1.5
20050233;276324;7;17.05.2023 00:00;59246;51842;7404;4.9
20050110;272075;7;17.05.2023 00:00;175725;158976;16749;14.3
20050350;272799;7;18.05.2023 00:00;12964;12099;865;1.0
20050349;272182;7;18.05.2023 00:00;140427;134210;6217;11.6
20050351;276135;7;19.05.2023 00:00;21135;17282;3853;1.6
20050160;272625;7;19.05.2023 00:00;29152;24194;4958;2.2
20050161;272878;7;19.05.2023 00:00;57202;52418;4784;4.5
20050163;276362;7;19.05.2023 00:00;128452;120962;7490;10.5
20050425;275877;7;20.05.2023 00:00;121720;116928;4792;10.3
20050423;271673;7;20.05.2023 00:00;28610;24192;4418;2.3
20050424;272810;7;20.05.2023 00:00;31067;24194;6873;2.1
20050426;281665;7;21.05.2023 00:00;132206;125570;6636;11.2
20050428;284063;7;21.05.2023 00:00;116023;100802;15221;8.9
20050716;283846;7;22.05.2023 00:00;171087;146304;24783;13.2
20050713;280466;7;22.05.2023 00:00;281532;254021;27511;22.5
20050447;277270;7;24.05.2023 00:00;235994;221760;14234;19.3
20050715;283545;7;25.05.2023 00:00;40138;31106;9032;2.7
20050711;279694;7;25.05.2023 00:00;67029;63936;3093;6.1
20050708;272829;7;25.05.2023 00:00;36567;31106;5461;2.9
20050709;273246;7;25.05.2023 00:00;34817;30816;4001;3.3
20050712;279717;7;26.05.2023 00:00;44586;37875;6711;3.4
20050714;283453;7;26.05.2023 00:00;33693;24192;9501;2.5
20050707;270325;7;26.05.2023 00:00;45831;35712;10119;3.8
20050710;279032;7;26.05.2023 00:00;56812;54722;2090;5.2
20050765;280160;7;27.05.2023 00:00;136870;120960;15910;10.6
20050764;280160;7;28.05.2023 00:00;130560;120960;9600;10.5
20050762;274103;7;28.05.2023 00:00;155444;149616;5828;12.9
20050763;275765;7;29.05.2023 00:00;682250;640946;41304;54.6
20050890;279156;7;31.05.2023 00:00;157311;142128;15183;12.0
20051054;284049;7;01.06.2023 00:00;216565;198722;17843;15.6
20050932;274522;7;02.06.2023 00:00;172748;145155;27593;12.3
20051055;279144;7;03.06.2023 00:00;209668;189506;20162;15.4
20051056;270339;7;03.06.2023 00:00;91069;83954;7115;6.8
20051068;273248;7;04.06.2023 00:00;41763;32691;9072;3.1
20051065;271543;7;04.06.2023 00:00;37223;31106;6117;2.9
20051066;272190;7;04.06.2023 00:00;36795;34560;2235;3.1
20051070;283523;7;04.06.2023 00:00;70918;66818;4100;6.0
20051104;273290;7;05.06.2023 00:00;73406;66242;7164;6.3
20051105;274587;7;05.06.2023 00:00;66159;54720;11439;5.4
20051128;269694;7;05.06.2023 00:00;68968;63362;5606;5.9
20051130;283902;7;06.06.2023 00:00;63417;57602;5815;5.5
20051129;274163;7;06.06.2023 00:00;59679;53856;5823;5.4
20051459;272878;7;06.06.2023 00:00;65039;52418;12621;4.4
20051238;276277;7;07.06.2023 00:00;54277;48386;5891;4.3
20051069;278654;7;07.06.2023 00:00;24592;25778;-1186;2.2
20051330;275877;7;07.06.2023 00:00;73375;66528;6847;6.0
20051329;275071;7;07.06.2023 00:00;53900;48384;5516;4.0
20051328;274101;7;08.06.2023 00:00;123331;116928;6403;10.2
20051333;283454;7;08.06.2023 00:00;57401;52416;4985;4.3
20051326;272010;7;08.06.2023 00:00;28150;24194;3956;2.2
20051327;272189;7;08.06.2023 00:00;77813;72579;5234;6.1
20051332;280373;7;09.06.2023 00:00;124716;108866;15850;8.9
20051334;284050;7;09.06.2023 00:00;77058;68546;8512;5.8
20051331;279156;7;10.06.2023 00:00;190672;169346;21326;14.0
20051351;283626;7;10.06.2023 00:00;81307;69408;11899;6.2
20051697;279135;7;11.06.2023 00:00;52444;44210;8234;3.4
20051350;280465;7;11.06.2023 00:00;200201;172512;27689;15.0
20051378;276362;7;12.06.2023 00:00;50324;52419;-2095;4.2
20051376;271988;7;12.06.2023 00:00;56040;48384;7656;4.1
20051377;273568;7;12.06.2023 00:00;99706;96771;2935;8.1
20051455;276322;7;13.06.2023 00:00;165190;154368;10822;13.0
20051554;280159;7;14.06.2023 00:00;197550;181297;16253;15.0
20051703;280159;7;17.06.2023 00:00;194475;181442;13033;15.1
20051704;280160;7;18.06.2023 00:00;128432;120819;7613;10.2
20051705;280160;7;18.06.2023 00:00;127217;120962;6255;10.0
20051706;280160;7;19.06.2023 00:00;130139;120962;9177;9.9
20052089;283742;7;20.06.2023 00:00;58475;44354;14121;3.8
20051762;275378;7;20.06.2023 00:00;32930;30530;2400;2.7
20051763;275616;7;20.06.2023 00:00;45647;34274;11373;2.9
20051768;284073;7;20.06.2023 00:00;20082;20738;-656;1.8
20051761;274518;7;21.06.2023 00:00;113145;101664;11481;8.8
20051769;284381;7;21.06.2023 00:00;26360;22610;3750;1.9
20051767;283957;7;21.06.2023 00:00;106170;85682;20488;7.4
20051765;279158;7;24.06.2023 00:00;37746;32403;5343;2.9
20052090;284417;7;24.06.2023 00:00;21222;17282;3940;1.5
20051766;283244;7;24.06.2023 00:00;427689;400898;26791;34.1
20052107;272810;7;26.06.2023 00:00;28418;24194;4224;2.1
20052334;284566;7;26.06.2023 00:00;312620;296213;16407;25.2
20052091;284487;7;26.06.2023 00:00;30402;28226;2176;2.5
20052108;274163;7;27.06.2023 00:00;40150;31683;8467;2.9
20052109;276134;7;27.06.2023 00:00;20119;14402;5717;1.3
20052333;284565;7;27.06.2023 00:00;183281;172800;10481;14.9
20052372;275075;7;27.06.2023 00:00;15728;14402;1326;1.3
20052482;272190;7;30.06.2023 00:00;20442;17282;3160;1.5
20052368;273248;7;30.06.2023 00:00;20894;17282;3612;1.5
20052373;276135;7;30.06.2023 00:00;17872;15554;2318;1.4
20052377;280465;7;30.06.2023 00:00;141170;127730;13440;11.2
20052378;280466;7;01.07.2023 00:00;99732;92738;6994;8.0
20052380;283742;7;01.07.2023 00:00;55410;48384;7026;4.5
20052379;282215;7;02.07.2023 00:00;34846;24768;10078;2.5
20052371;274523;7;02.07.2023 00:00;47380;36288;11092;2.8
20052366;272321;7;02.07.2023 00:00;13482;27938;-14456;2.4
20052690;272565;7;02.07.2023 00:00;38181;35426;2755;2.8
20052376;279405;7;02.07.2023 00:00;55864;49250;6614;4.1
20052374;277192;7;03.07.2023 00:00;40858;28224;12634;2.5
20052375;278287;7;03.07.2023 00:00;60642;48386;12256;4.3
20052693;274686;7;03.07.2023 00:00;27682;24194;3488;2.0
20052695;275877;7;03.07.2023 00:00;47953;44354;3599;3.7
20052697;278287;7;03.07.2023 00:00;25632;24194;1438;2.0
20052694;275066;7;04.07.2023 00:00;30341;24194;6147;2.3
20052562;284639;7;04.07.2023 00:00;511124;476931;34193;40.1
20052698;279136;7;04.07.2023 00:00;58410;53424;4986;4.6
20052692;274587;7;06.07.2023 00:00;14219;11521;2698;1.2
20052699;283902;7;06.07.2023 00:00;33954;26066;7888;2.3
20052696;276134;7;06.07.2023 00:00;18000;15120;2880;1.5
20052880;284679;7;07.07.2023 00:00;332448;300964;31484;27.1
20052712;272799;7;08.07.2023 00:00;20548;17282;3266;1.5
20052509;280160;7;08.07.2023 00:00;136813;120963;15850;10.1
20052510;280160;7;09.07.2023 00:00;126180;120960;5220;10.2
20052511;280160;7;09.07.2023 00:00;129982;120962;9020;10.3
20053090;284386;7;10.07.2023 00:00;19150;17282;1868;1.5
20053082;284189;7;10.07.2023 00:00;110602;101664;8938;8.9
20053088;283627;7;10.07.2023 00:00;108820;95042;13778;8.2
20053089;284380;7;11.07.2023 00:00;31480;28226;3254;2.4
20053085;270325;7;11.07.2023 00:00;43800;32258;11542;3.0
20052354;284620;7;11.07.2023 00:00;5002;5002;0;0.9
20052797;280466;7;11.07.2023 00:00;115600;106274;9326;9.1
20052799;284049;7;12.07.2023 00:00;74260;68259;6001;5.4
20052881;284720;7;12.07.2023 00:00;189620;177408;12212;14.4
20053091;284485;7;13.07.2023 00:00;33308;28083;5225;2.3
20053258;280373;7;13.07.2023 00:00;15950;12098;3852;1.0
20053257;279156;7;13.07.2023 00:00;31974;28226;3748;2.4
20053086;275069;7;13.07.2023 00:00;26732;25633;1099;2.2
20053087;282278;7;13.07.2023 00:00;30956;24194;6762;2.1
20052796;270324;7;14.07.2023 00:00;43250;33410;9840;3.1
20054174;275075;7;07.08.2023 00:00;37402;27650;9752;2.9
20054173;269694;7;07.08.2023 00:00;32276;25922;6354;2.5
20054175;273553;7;07.08.2023 00:00;36398;33264;3134;2.8
20054182;284386;7;07.08.2023 00:00;39383;36147;3236;3.1
20054183;284417;7;07.08.2023 00:00;24073;17285;6788;1.5
20054234;284919;7;08.08.2023 00:00;6914;6914;0;1.5
20054193;276324;7;08.08.2023 00:00;55782;51842;3940;4.3
20054176;284214;7;08.08.2023 00:00;32380;24192;8188;2.2
20054184;284882;7;08.08.2023 00:00;40547;34562;5985;3.0
20054177;284566;7;08.08.2023 00:00;167832;150770;17062;13.0
20054161;283846;7;09.08.2023 00:00;41438;29090;12348;2.4
20054160;280466;7;09.08.2023 00:00;161769;145154;16615;12.3
20054245;274518;7;10.08.2023 00:00;14917;11522;3395;1.0
20054169;284050;7;10.08.2023 00:00;37543;24195;13348;2.1
20054295;284956;7;10.08.2023 00:00;17082;15122;1960;1.2
20054167;279019;7;10.08.2023 00:00;27550;24194;3356;2.0
20054166;273010;7;10.08.2023 00:00;31545;24194;7351;2.2
20054244;272565;7;11.08.2023 00:00;12982;10658;2324;0.8
20054246;284485;7;11.08.2023 00:00;29328;24194;5134;2.0
20054247;284720;7;11.08.2023 00:00;83204;79490;3714;6.8
20054312;284920;7;11.08.2023 00:00;8066;8066;0;0.7
20054306;271673;7;11.08.2023 00:00;50928;44352;6576;4.3
20054307;275071;7;12.08.2023 00:00;62733;52416;10317;4.7
20054309;284380;7;12.08.2023 00:00;56527;48364;8163;4.7
20054308;275877;7;13.08.2023 00:00;132502;120962;11540;11.2
20054320;272810;7;13.08.2023 00:00;26500;24192;2308;2.4
20054319;272010;7;13.08.2023 00:00;29500;24192;5308;2.1
20054323;284487;7;13.08.2023 00:00;27400;24192;3208;2.3
20054322;284075;7;14.08.2023 00:00;110946;100658;10288;8.6
20054414;272189;7;14.08.2023 00:00;72461;64514;7947;5.3
20054415;272289;7;14.08.2023 00:00;155052;149186;5866;12.5
20054450;279158;7;15.08.2023 00:00;20241;17282;2959;1.4
20054454;271952;7;15.08.2023 00:00;19380;14978;4402;1.3
20054448;272190;7;15.08.2023 00:00;34265;31106;3159;2.6
20054449;274587;7;15.08.2023 00:00;35196;28802;6394;2.6
20054453;284991;7;15.08.2023 00:00;62932;54722;8210;4.7
20054548;284679;7;16.08.2023 00:00;215213;198434;16779;17.4
20054638;285048;7;17.08.2023 00:00;140;140;0;0.2
20054550;284853;7;17.08.2023 00:00;37342;18432;18910;1.6
20054544;270325;7;17.08.2023 00:00;15364;13682;1682;1.2
20054549;284680;7;18.08.2023 00:00;37749;28227;9522;3.3
20054547;284063;7;18.08.2023 00:00;29288;25059;4229;2.2
20054545;279032;7;18.08.2023 00:00;15317;13826;1491;1.1
20054551;285033;7;18.08.2023 00:00;161591;151202;10389;12.7
20054546;279156;7;19.08.2023 00:00;117559;104834;12725;8.9
20054582;284049;7;21.08.2023 00:00;169273;162434;6839;13.1
20054580;283530;7;21.08.2023 00:00;30117;24194;5923;2.0
20055065;270324;7;22.08.2023 00:00;23168;16995;6173;1.5
20054799;;7;22.08.2023 00:00;0;0;0;0.0
20054584;284857;7;22.08.2023 00:00;56970;43490;13480;4.0
20054855;284647;7;22.08.2023 00:00;17002;10370;6632;1.1
20054583;284837;7;23.08.2023 00:00;144165;126722;17443;10.4
20054581;283698;7;23.08.2023 00:00;346367;317954;28413;27.3
20054842;284836;7;25.08.2023 00:00;14178;10371;3807;0.9
20054840;284644;7;25.08.2023 00:00;13132;10370;2762;0.9
20054905;284645;7;25.08.2023 00:00;23772;20738;3034;1.7
20054841;284831;7;25.08.2023 00:00;14672;12098;2574;1.0
20054906;284944;7;25.08.2023 00:00;75232;69986;5246;5.7
20054958;284795;7;26.08.2023 00:00;60654;51842;8812;4.7
20054957;284648;7;26.08.2023 00:00;189969;173954;16015;14.8
20054956;284124;7;28.08.2023 00:00;23332;14544;8788;1.3
20054800;;7;29.08.2023 00:00;0;0;0;0.0
20055251;275877;7;29.08.2023 00:00;208712;181443;27269;16.0
20055245;284075;7;30.08.2023 00:00;103379;96770;6609;8.5
20055246;284566;7;30.08.2023 00:00;106294;96770;9524;8.3
20055127;284677;7;31.08.2023 00:00;282442;260354;22088;22.6
20055034;280160;7;01.09.2023 00:00;135306;120962;14344;10.6
20055033;280160;7;01.09.2023 00:00;136258;120962;15296;10.5
20055035;280160;7;04.09.2023 00:00;131882;120962;10920;10.6
20055067;280160;7;04.09.2023 00:00;127611;120962;6649;10.7
20055235;269694;7;05.09.2023 00:00;21057;14402;6655;1.3
20055236;283902;7;05.09.2023 00:00;33163;28800;4363;2.9
20055297;277970;7;05.09.2023 00:00;88520;83522;4998;7.2
20055300;285082;7;06.09.2023 00:00;200910;181442;19468;16.1
20055587;285202;7;07.09.2023 00:00;65583;56451;9132;5.0
20055544;274518;7;07.09.2023 00:00;15712;12674;3038;1.1
20055298;280466;7;07.09.2023 00:00;42436;36288;6148;3.0
20055360;284073;7;07.09.2023 00:00;25715;24192;1523;2.0
20055299;283626;7;07.09.2023 00:00;16880;12096;4784;1.1
20055545;283545;7;07.09.2023 00:00;17806;16562;1244;1.4
20055361;285081;7;08.09.2023 00:00;90116;80498;9618;6.7
20055358;283822;7;08.09.2023 00:00;35150;26498;8652;2.5
20055558;285010;7;08.09.2023 00:00;32414;26930;5484;2.3
20055524;284720;7;08.09.2023 00:00;44925;45362;-437;3.6
20055548;284683;7;09.09.2023 00:00;40586;28226;12360;2.6
20055546;284566;7;11.09.2023 00:00;157033;145154;11879;13.0
20055547;284679;7;11.09.2023 00:00;216739;192962;23777;17.0
20055549;284991;7;12.09.2023 00:00;11007;10658;349;0.9
20056013;269694;7;12.09.2023 00:00;55113;43202;11911;4.2
20055554;272190;7;13.09.2023 00:00;19666;13825;5841;1.2
20055552;272075;7;13.09.2023 00:00;175737;165314;10423;14.8
20055543;271543;7;13.09.2023 00:00;15450;13824;1626;1.1
20055964;285304;7;14.09.2023 00:00;1;1;0;6.7
20055557;284386;7;14.09.2023 00:00;38904;31106;7798;2.7
20055556;273553;7;14.09.2023 00:00;19353;15841;3512;1.5
20055553;272182;7;14.09.2023 00:00;13130;10370;2760;1.0
20055555;272799;7;14.09.2023 00:00;34471;32402;2069;3.0
20055761;277975;7;15.09.2023 00:00;383451;332643;50808;27.1
20055893;;7;15.09.2023 00:00;0;0;0;0.0
20055763;277975;7;18.09.2023 00:00;349702;332642;17060;25.6
20055762;277975;7;19.09.2023 00:00;351542;332642;18900;25.9
20056251;285236;7;20.09.2023 00:00;121584;104546;17038;8.6
20056152;285035;7;21.09.2023 00:00;47109;45256;1853;3.6
20056297;285321;7;21.09.2023 00:00;57929;51064;6865;4.1
20055894;;7;21.09.2023 00:00;0;0;0;0.0
20055986;284049;7;21.09.2023 00:00;26508;20165;6343;1.6
20056298;285322;7;21.09.2023 00:00;38185;30530;7655;2.4
20055987;284720;7;22.09.2023 00:00;23497;20162;3335;1.6
20056077;284485;7;22.09.2023 00:00;63842;60482;3360;4.7
20056076;272565;7;22.09.2023 00:00;81631;76610;5021;6.1
20056295;279019;7;22.09.2023 00:00;24921;25058;-137;2.0
20056296;280473;7;22.09.2023 00:00;35702;30962;4740;2.6
20056293;279278;7;23.09.2023 00:00;9431;10946;-1515;1.0
20056174;273553;7;23.09.2023 00:00;34064;30962;3102;2.6
20055983;270339;7;23.09.2023 00:00;26010;17280;8730;1.6
20056461;284386;7;25.09.2023 00:00;37002;34562;2440;3.0
20056139;275066;7;25.09.2023 00:00;38484;30962;7522;2.6
20056176;284380;7;25.09.2023 00:00;54458;48387;6071;4.2
20056460;271543;7;25.09.2023 00:00;21435;18434;3001;1.6
20056178;284676;7;25.09.2023 00:00;59029;52418;6611;4.6
20056172;272189;7;26.09.2023 00:00;17292;16130;1162;1.4
20056173;272810;7;26.09.2023 00:00;28165;26498;1667;2.3
20056140;285189;7;26.09.2023 00:00;64406;56451;7955;5.0
20056177;284566;7;26.09.2023 00:00;279800;254018;25782;22.2
20056179;284679;7;27.09.2023 00:00;64513;48962;15551;4.2
20056175;274587;7;28.09.2023 00:00;13450;11523;1927;1.0
20056431;280466;7;28.09.2023 00:00;115424;104834;10590;9.2
20056458;268794;7;28.09.2023 00:00;32259;28226;4033;2.4
20056459;283545;7;28.09.2023 00:00;18361;13827;4534;1.2
20056515;279144;7;29.09.2023 00:00;160359;131328;29031;11.7
20056568;272565;7;09.10.2023 00:00;61353;52418;8935;4.2
20056570;284050;7;09.10.2023 00:00;111396;100802;10594;8.2
20056751;284485;7;09.10.2023 00:00;29348;24195;5153;2.0
20056569;282215;7;09.10.2023 00:00;27509;24194;3315;2.2
20056750;280465;7;10.10.2023 00:00;39106;28514;10592;2.9
20056829;285386;7;10.10.2023 00:00;45222;28802;16420;2.7
20056828;284991;7;10.10.2023 00:00;32428;17282;15146;1.7
20056827;284679;7;11.10.2023 00:00;487662;435746;51916;38.6
20057104;284565;7;13.10.2023 00:00;154623;136802;17821;11.9
20057101;272182;7;13.10.2023 00:00;21103;19010;2093;1.7
20057102;279158;7;13.10.2023 00:00;38898;34560;4338;3.1
20057105;284682;7;14.10.2023 00:00;15282;18146;-2864;1.5
20057103;284075;7;14.10.2023 00:00;117099;98210;18889;8.7
20057111;272189;7;16.10.2023 00:00;58949;52418;6531;4.6
20057345;284566;7;16.10.2023 00:00;208722;189506;19216;16.9
20057344;279136;7;16.10.2023 00:00;51088;48386;2702;4.1
20057166;285287;7;17.10.2023 00:00;139519;126434;13085;10.5
20057256;284720;7;18.10.2023 00:00;313825;274178;39647;23.3
20057347;272565;7;19.10.2023 00:00;18280;16128;2152;1.2
20057349;279019;7;19.10.2023 00:00;31792;28226;3566;2.3
20057255;284049;7;19.10.2023 00:00;26060;24192;1868;2.0
20057350;279156;7;20.10.2023 00:00;250976;239042;11934;19.7
20057348;275069;7;20.10.2023 00:00;27828;24194;3634;2.0
20057352;285322;7;21.10.2023 00:00;46535;43778;2757;3.4
20057351;285126;7;23.10.2023 00:00;388690;324803;63887;26.9
20057353;285384;7;23.10.2023 00:00;63117;53426;9691;4.8
20057826;285745;7;26.10.2023 00:00;20000;20000;0;6.9
20057587;280466;7;26.10.2023 00:00;168139;141122;27017;12.5
20057586;278654;7;27.10.2023 00:00;29693;24194;5499;2.1
20057588;283626;7;27.10.2023 00:00;33336;24194;9142;2.3
20057584;272010;7;27.10.2023 00:00;26647;24194;2453;2.1
20057590;284487;7;27.10.2023 00:00;25690;24194;1496;2.2
20057591;284676;7;27.10.2023 00:00;28198;24050;4148;2.0
20057589;284380;7;27.10.2023 00:00;72128;48387;23741;4.2
20057585;275877;7;30.10.2023 00:00;115444;88706;26738;7.6
20058021;271988;7;30.10.2023 00:00;29363;26498;2865;2.3
20058026;284075;7;30.10.2023 00:00;25723;24194;1529;2.1
20057671;285189;7;30.10.2023 00:00;25942;22178;3764;2.0
20058027;284677;7;30.10.2023 00:00;46028;40322;5706;3.9
20057668;271952;7;31.10.2023 00:00;21304;17138;4166;1.6
20057670;284882;7;31.10.2023 00:00;21442;17282;4160;1.6
20057669;273553;7;31.10.2023 00:00;80364;72578;7786;6.2
20058023;272190;7;31.10.2023 00:00;21980;18866;3114;1.8
20057697;284417;7;31.10.2023 00:00;23972;19010;4962;1.8
20058020;271543;7;01.11.2023 00:00;18043;14978;3065;1.3
20057731;269694;7;01.11.2023 00:00;68617;54720;13897;5.2
20058024;272799;7;01.11.2023 00:00;19020;15842;3178;1.5
20058022;272182;7;01.11.2023 00:00;13724;12098;1626;1.1
20057732;277970;7;01.11.2023 00:00;96442;86402;10040;8.0
20057785;284681;7;02.11.2023 00:00;15792;14402;1390;1.3
20058025;274587;7;02.11.2023 00:00;49519;43204;6315;3.9
20057786;284991;7;02.11.2023 00:00;40108;28802;11306;2.8
20057773;283978;7;02.11.2023 00:00;18385;14402;3983;1.3
20057775;284485;7;02.11.2023 00:00;38828;26498;12330;2.3
20057733;284049;7;03.11.2023 00:00;67490;60483;7007;5.3
20057772;283530;7;03.11.2023 00:00;34852;26498;8354;2.2
20057783;270325;7;03.11.2023 00:00;69668;54723;14945;5.3
20057784;279717;7;03.11.2023 00:00;28961;22466;6495;2.0
20057774;284381;7;04.11.2023 00:00;24803;23906;897;2.0
20058325;285673;7;04.11.2023 00:00;85542;68402;17140;6.2
20057771;280465;7;06.11.2023 00:00;125328;109442;15886;10.0
20058063;280466;7;07.11.2023 00:00;136382;100802;35580;8.8
20058065;285033;7;07.11.2023 00:00;92885;79778;13107;6.8
20058064;284566;7;08.11.2023 00:00;214933;201602;13331;17.0
20058088;285189;7;08.11.2023 00:00;52148;48386;3762;4.2
20058087;284677;7;09.11.2023 00:00;218744;203904;14840;17.6
20058217;275877;7;09.11.2023 00:00;82027;72579;9448;6.1
20058218;284075;7;10.11.2023 00:00;58501;52418;6083;4.6
20058216;272810;7;10.11.2023 00:00;60373;52418;7955;4.6
20058306;284676;7;10.11.2023 00:00;52204;48386;3818;4.2
20058305;275066;7;11.11.2023 00:00;22824;20162;2662;1.7
20058303;273568;7;11.11.2023 00:00;66377;49251;17126;4.6
20058304;274686;7;11.11.2023 00:00;31002;28226;2776;2.5
20058331;280159;7;13.11.2023 00:00;204431;181443;22988;15.6
20058307;284882;7;14.11.2023 00:00;33869;19010;14859;1.9
20058552;285286;7;14.11.2023 00:00;26547;21314;5233;1.8
20058373;285808;7;14.11.2023 00:00;15554;15554;0;8.1
20058374;285807;7;15.11.2023 00:00;22898;22898;0;8.2
20058375;285811;7;15.11.2023 00:00;15554;15554;0;3.9
20058372;285805;7;15.11.2023 00:00;22034;22034;0;8.8
20058448;285615;7;15.11.2023 00:00;96785;86401;10384;7.7
20058550;284050;7;16.11.2023 00:00;30420;20163;10257;1.8
20058551;285284;7;16.11.2023 00:00;11978;10946;1032;0.9
20059188;284050;7;27.11.2023 00:00;140389;108867;31522;9.5
20059186;283530;7;27.11.2023 00:00;60527;52418;8109;4.5
20059187;284048;7;28.11.2023 00:00;26544;24194;2350;2.1
20059184;280122;7;28.11.2023 00:00;24502;23474;1028;1.9
20059183;279144;7;28.11.2023 00:00;122813;103682;19131;9.0
20059185;280466;7;28.11.2023 00:00;111565;96770;14795;8.5
20059189;284073;7;29.11.2023 00:00;74214;56450;17764;5.2
20059192;285625;7;29.11.2023 00:00;21872;17282;4590;1.5
20059182;277270;7;29.11.2023 00:00;22722;22178;544;1.9
20058823;274163;7;30.11.2023 00:00;24495;20162;4333;2.0
20058709;284677;7;30.11.2023 00:00;186129;165890;20239;14.5
20058915;284677;7;30.11.2023 00:00;238896;207362;31534;18.0
20059190;284214;7;02.12.2023 00:00;81268;76610;4658;6.5
20059191;284566;7;04.12.2023 00:00;163589;141986;21603;12.5
20059281;285285;7;04.12.2023 00:00;30714;28082;2632;2.4
20059201;284380;7;04.12.2023 00:00;52757;49394;3363;4.3
20059198;272189;7;05.12.2023 00:00;55092;48387;6705;4.0
20059197;271673;7;05.12.2023 00:00;26386;24194;2192;2.0
20059200;284075;7;05.12.2023 00:00;103416;92594;10822;8.2
20059199;275877;7;06.12.2023 00:00;118954;96626;22328;8.3
20059276;272878;7;06.12.2023 00:00;20698;20162;536;1.8
20059278;284386;7;06.12.2023 00:00;87022;69122;17900;5.9
20059277;273553;7;07.12.2023 00:00;49240;44930;4310;3.8
20059279;284565;7;07.12.2023 00:00;88496;82946;5550;7.2
20059280;284882;7;07.12.2023 00:00;40890;31250;9640;2.9
20059421;285202;7;08.12.2023 00:00;170674;144434;26240;12.7
20059423;285641;7;11.12.2023 00:00;36104;29234;6870;2.4
20059420;282215;7;11.12.2023 00:00;52597;49250;3347;4.3
20059424;285653;7;12.12.2023 00:00;32910;28224;4686;2.3
20059422;285322;7;12.12.2023 00:00;139162;122978;16184;10.3
20059639;280160;7;12.12.2023 00:00;127542;120962;6580;9.9
20059655;286121;7;12.12.2023 00:00;30918;17282;13636;1.7
20059638;280160;7;13.12.2023 00:00;132346;120962;11384;11.1
20059637;280159;7;14.12.2023 00:00;196361;181442;14919;15.2
20059642;280159;7;14.12.2023 00:00;194177;181442;12735;15.3
20059641;280159;7;15.12.2023 00:00;202287;181298;20989;15.5
20059643;284677;7;16.12.2023 00:00;317202;297218;19984;24.6
20059656;286123;7;17.12.2023 00:00;38579;30961;7618;2.5
20059651;269694;7;17.12.2023 00:00;31207;25923;5284;2.5
20059652;282124;7;17.12.2023 00:00;28100;26640;1460;2.2
20059653;284681;7;18.12.2023 00:00;17463;14402;3061;1.4
20059654;284991;7;18.12.2023 00:00;69683;54146;15537;5.4
20059326;285684;7;18.12.2023 00:00;31023;18866;12157;2.1
20059325;;7;18.12.2023 00:00;0;0;0;0.0
20059491;284648;7;19.12.2023 00:00;108072;100228;7844;8.9
20059490;284645;7;19.12.2023 00:00;47155;44930;2225;4.1
20059509;285635;7;19.12.2023 00:00;28203;24195;4008;1.8
20059510;285774;7;19.12.2023 00:00;27692;23042;4650;2.3
20059507;284944;7;20.12.2023 00:00;103722;96770;6952;8.5
20059542;285890;7;20.12.2023 00:00;131623;109584;22039;10.2
20059506;284795;7;20.12.2023 00:00;36484;31106;5378;2.7
20059689;284644;7;21.12.2023 00:00;15919;10371;5548;1.0
20059690;285723;7;22.12.2023 00:00;11384;10226;1158;1.0
20059541;284831;7;22.12.2023 00:00;153203;121106;32097;11.1
20059620;285680;7;23.12.2023 00:00;20002;18866;1136;1.7
20059619;283698;7;23.12.2023 00:00;86895;83808;3087;6.8
20059844;284836;7;23.12.2023 00:00;15225;10371;4854;1.4
20059854;285907;7;23.12.2023 00:00;25788;24194;1594;2.3
20059853;285898;7;03.01.2024 00:00;14451;12672;1779;1.2
20059852;285792;7;03.01.2024 00:00;21254;11954;9300;1.0
20059849;285605;7;03.01.2024 00:00;31680;24624;7056;2.3
20059851;285683;7;03.01.2024 00:00;16300;11520;4780;1.1
20059845;284837;7;03.01.2024 00:00;171320;146880;24440;12.6
20059848;285374;7;04.01.2024 00:00;13946;10659;3287;1.0
20059843;284123;7;04.01.2024 00:00;38595;25347;13248;2.5
20059846;284975;7;04.01.2024 00:00;30002;28802;1200;2.5
20059847;284975;7;04.01.2024 00:00;32894;31538;1356;2.7
20059850;285651;7;05.01.2024 00:00;14455;10370;4085;1.1
20059855;285914;7;05.01.2024 00:00;30419;26209;4210;2.4
20059838;;7;05.01.2024 00:00;0;0;0;0.0
20059873;270325;7;05.01.2024 00:00;48877;32259;16618;3.2
20059875;279717;7;05.01.2024 00:00;58199;41475;16724;4.1
20059874;275378;7;06.01.2024 00:00;26864;20017;6847;1.8
20059877;284063;7;08.01.2024 00:00;115158;104834;10324;9.2
20059879;285781;7;08.01.2024 00:00;35435;28225;7210;2.5
20060018;280466;7;08.01.2024 00:00;107568;99648;7920;8.7
20059876;280465;7;09.01.2024 00:00;63586;54722;8864;4.8
20059880;285843;7;09.01.2024 00:00;72500;69840;2660;6.1
20060019;284485;7;10.01.2024 00:00;105932;92738;13194;7.6
20060015;275764;7;10.01.2024 00:00;30745;24195;6550;2.0
20060013;272565;7;10.01.2024 00:00;116249;100802;15447;9.0
20060017;279019;7;11.01.2024 00:00;112500;92739;19761;7.8
20060210;286272;7;11.01.2024 00:00;2592;4320;-1728;3.2
20060416;283627;7;12.01.2024 00:00;98226;86402;11824;7.8
20059882;274587;7;12.01.2024 00:00;19739;14403;5336;1.5
20059878;285288;7;12.01.2024 00:00;31814;28802;3012;2.4
20060016;277970;7;12.01.2024 00:00;91096;84384;6712;7.5
20060020;285286;7;13.01.2024 00:00;25170;20160;5010;1.8
20060190;272878;7;13.01.2024 00:00;14270;10656;3614;0.9
20060027;275877;7;15.01.2024 00:00;211034;193538;17496;16.7
20060026;272189;7;15.01.2024 00:00;53558;44355;9203;3.8
20060515;273568;7;16.01.2024 00:00;106239;100946;5293;8.6
20060208;286160;7;16.01.2024 00:00;66826;56448;10378;5.0
20060207;284214;7;16.01.2024 00:00;158686;148610;10076;12.6
20060418;285379;7;16.01.2024 00:00;30352;28226;2126;2.3
20060283;284566;7;17.01.2024 00:00;362988;342722;20266;28.7
20060284;284677;7;18.01.2024 00:00;141346;122114;19232;10.6
20060419;286252;7;19.01.2024 00:00;43166;29952;13214;2.9
20060866;285033;7;19.01.2024 00:00;131092;120962;10130;10.5
20060538;284050;7;22.01.2024 00:00;51992;40322;11670;3.8
20060539;285081;7;22.01.2024 00:00;35360;26352;9008;2.1
20060537;279156;7;22.01.2024 00:00;173810;157392;16418;13.3
20060605;284049;7;23.01.2024 00:00;127983;113042;14941;9.4
20060648;285842;7;23.01.2024 00:00;356703;330626;26077;27.0
20060606;284051;7;23.01.2024 00:00;29184;27938;1246;2.3
20060607;284486;7;25.01.2024 00:00;29939;24195;5744;2.3
20060747;283976;7;25.01.2024 00:00;29117;25058;4059;2.2
20060865;286327;7;25.01.2024 00:00;407007;357122;49885;32.0
20060864;285288;7;29.01.2024 00:00;34226;28800;5426;2.6
20060862;274587;7;29.01.2024 00:00;35311;25922;9389;2.2
20061250;284991;7;29.01.2024 00:00;102237;81794;20443;7.2
20060852;284677;7;29.01.2024 00:00;280232;262802;17430;22.0
20060853;285189;7;30.01.2024 00:00;75266;72578;2688;6.0
20060978;282124;7;31.01.2024 00:00;59654;52418;7236;4.7
20060850;272810;7;31.01.2024 00:00;106194;96624;9570;8.4
20060746;271988;7;31.01.2024 00:00;77665;72761;4904;6.1
20060823;271673;7;01.02.2024 00:00;54201;48389;5812;4.1
20060851;279136;7;01.02.2024 00:00;54691;48385;6306;4.3
20060825;284676;7;01.02.2024 00:00;53313;48386;4927;4.5
20061077;284075;7;01.02.2024 00:00;77696;72578;5118;6.1
20061139;284380;7;02.02.2024 00:00;58926;48387;10539;4.6
20061075;272878;7;02.02.2024 00:00;20967;16130;4837;1.5
20061140;285379;7;02.02.2024 00:00;60266;52128;8138;4.5
20061252;286365;7;02.02.2024 00:00;214484;193538;20946;15.8
20061138;273553;7;05.02.2024 00:00;113674;96192;17482;8.4
20061253;286436;7;05.02.2024 00:00;30405;28226;2179;2.4
20061489;275509;7;06.02.2024 00:00;1;1;0;0.0
20061301;271952;7;06.02.2024 00:00;93055;82946;10109;7.2
20061302;285382;7;06.02.2024 00:00;44133;34563;9570;3.2
20061417;279866;7;06.02.2024 00:00;7215;5472;1743;0.6
20061371;285843;7;07.02.2024 00:00;73162;54722;18440;5.1
20061368;280465;7;07.02.2024 00:00;102240;85392;16848;7.7
20061369;280466;7;08.02.2024 00:00;58052;48386;9666;4.5
20061372;286132;7;08.02.2024 00:00;52457;42914;9543;3.9
20061435;286487;7;08.02.2024 00:00;115019;100800;14219;8.1
20061567;278177;7;08.02.2024 00:00;5042;5042;0;0.5
20061455;284050;7;09.02.2024 00:00;157528;149187;8341;12.3
20061454;279144;7;09.02.2024 00:00;113763;97778;15985;8.5
20061251;286327;7;10.02.2024 00:00;224552;191666;32886;18.6
20061600;284189;7;12.02.2024 00:00;76872;69123;7749;6.0
20061601;286500;7;12.02.2024 00:00;367520;329328;38192;28.6
20061749;286121;7;14.02.2024 00:00;46752;38018;8734;3.4
20061745;284386;7;14.02.2024 00:00;100090;89282;10808;7.7
20061742;272190;7;15.02.2024 00:00;54773;49538;5235;4.3
20061743;280253;7;15.02.2024 00:00;38031;29666;8365;2.7
20061876;284075;7;15.02.2024 00:00;114472;100803;13669;8.8
20061879;286622;7;16.02.2024 00:00;171551;157249;14302;13.2
20061877;284380;7;16.02.2024 00:00;50002;48386;1616;4.0
20061744;284214;7;16.02.2024 00:00;27940;24195;3745;2.1
20061878;284677;7;17.02.2024 00:00;239314;214992;24322;18.3
20061883;286327;7;19.02.2024 00:00;105927;89282;16645;8.2
20061884;286611;7;20.02.2024 00:00;95956;83523;12433;7.9
20061881;274587;7;20.02.2024 00:00;37382;25922;11460;2.6
20061965;277970;7;20.02.2024 00:00;91028;83522;7506;7.3
20061919;;7;21.02.2024 00:00;0;0;0;0.0
20062294;285386;7;21.02.2024 00:00;58232;57602;630;5.0
20062011;286442;7;21.02.2024 00:00;179748;136084;43664;11.4
20062013;286445;7;22.02.2024 00:00;469337;423364;45973;34.1
20062012;286445;7;26.02.2024 00:00;449285;423362;25923;33.8
20061920;;7;28.02.2024 00:00;0;0;0;0.0
20062356;285287;7;28.02.2024 00:00;162157;124995;37162;11.1
20062357;285842;7;29.02.2024 00:00;315835;294770;21065;23.4
20062476;283530;7;01.03.2024 00:00;29597;24194;5403;1.9
20062605;286881;7;01.03.2024 00:00;10082;10082;0;4.0
20062707;285384;7;02.03.2024 00:00;52516;48386;4130;3.8
20062867;279019;7;04.03.2024 00:00;179114;156960;22154;13.7
20062708;286361;7;04.03.2024 00:00;35000;28224;6776;2.2
20062705;284050;7;04.03.2024 00:00;58133;52419;5714;4.1
20062704;280473;7;04.03.2024 00:00;23690;20160;3530;1.7
20062868;279156;7;05.03.2024 00:00;209210;185472;23738;15.1
20062512;286487;7;06.03.2024 00:00;109852;100802;9050;8.1
20062513;284049;7;06.03.2024 00:00;392127;354820;37307;28.2
20062720;286857;7;08.03.2024 00:00;112089;100802;11287;8.0
20062625;286802;7;08.03.2024 00:00;57615;52418;5197;4.4
20062706;284485;7;08.03.2024 00:00;71316;64512;6804;5.3
20062864;286915;7;09.03.2024 00:00;31650;30963;687;2.5
20062846;280122;7;09.03.2024 00:00;32382;26496;5886;2.2
20062729;270339;7;09.03.2024 00:00;57183;48386;8797;3.9
20062730;279144;7;09.03.2024 00:00;147166;133056;14110;11.0
20063032;279717;7;10.03.2024 00:00;66276;55299;10977;4.8
20063030;279032;7;10.03.2024 00:00;69676;62208;7468;5.6
20063027;270325;7;10.03.2024 00:00;44882;36866;8016;3.5
20063066;284853;7;11.03.2024 00:00;19420;19584;-164;2.0
20063068;286252;7;11.03.2024 00:00;26050;20160;5890;1.8
20063060;275378;7;11.03.2024 00:00;58555;56450;2105;5.3
20063063;284063;7;11.03.2024 00:00;87737;72288;15449;6.7
20063064;284073;7;12.03.2024 00:00;76275;64514;11761;5.6
20063067;285033;7;12.03.2024 00:00;194984;185474;9510;16.2
20063065;284383;7;13.03.2024 00:00;33167;30531;2636;2.5
20063069;286751;7;13.03.2024 00:00;57228;52418;4810;4.7
20063062;283626;7;13.03.2024 00:00;102890;96770;6120;8.4
20063061;280466;7;14.03.2024 00:00;265384;243362;22022;21.1
20062847;280465;7;15.03.2024 00:00;222124;192963;29161;17.9
20062848;285843;7;16.03.2024 00:00;130001;112177;17824;9.8
20062979;271618;7;16.03.2024 00:00;19553;17282;2271;1.5
20062981;285673;7;17.03.2024 00:00;15524;13826;1698;1.2
20062982;286818;7;17.03.2024 00:00;18894;17138;1756;1.5
20062980;283545;7;17.03.2024 00:00;39914;35139;4775;3.0
20063031;279135;7;17.03.2024 00:00;73590;65664;7926;5.7
20063180;275877;7;17.03.2024 00:00;436905;395138;41767;34.4
20063296;275066;7;20.03.2024 00:00;25508;24194;1314;2.1
20063298;284676;7;20.03.2024 00:00;52186;48385;3801;4.2
20063299;284683;7;20.03.2024 00:00;32694;24194;8500;2.1
20063297;284075;7;20.03.2024 00:00;103722;101810;1912;9.0
20063387;283627;7;21.03.2024 00:00;82100;68977;13123;6.5
20063478;286327;7;21.03.2024 00:00;199129;184322;14807;16.0
20063550;284681;7;22.03.2024 00:00;41573;25921;15652;2.3
20063552;285288;7;22.03.2024 00:00;62700;57600;5100;5.1
20063541;269694;7;23.03.2024 00:00;59338;54722;4616;4.7
20063554;286859;7;23.03.2024 00:00;35138;28226;6912;2.6
20063553;286160;7;23.03.2024 00:00;21002;20162;840;1.9
20063546;279788;7;23.03.2024 00:00;32576;28224;4352;2.6
20063549;284454;7;23.03.2024 00:00;31512;28226;3286;2.5
20063545;279136;7;24.03.2024 00:00;53614;48386;5228;4.2
20063543;272189;7;24.03.2024 00:00;48480;44208;4272;3.9
20063548;284380;7;24.03.2024 00:00;53600;52418;1182;4.5
20063542;271673;7;24.03.2024 00:00;75990;72578;3412;6.4
20063547;282124;7;24.03.2024 00:00;58103;51401;6702;4.7
20063544;273568;7;25.03.2024 00:00;94875;91730;3145;8.0
20063551;285189;7;25.03.2024 00:00;83612;76610;7002;6.9
20063592;284214;7;25.03.2024 00:00;117069;105267;11802;8.9
20063621;284389;7;26.03.2024 00:00;71496;67106;4390;6.0
20063616;271543;7;26.03.2024 00:00;36712;34274;2438;3.1
20063617;273248;7;26.03.2024 00:00;55371;48240;7131;4.4
20063618;273553;7;27.03.2024 00:00;109927;103682;6245;8.8
20063619;276324;7;27.03.2024 00:00;40748;38018;2730;3.3
20063620;284189;7;27.03.2024 00:00;126424;117506;8918;10.3
20063739;284484;7;28.03.2024 00:00;19494;17282;2212;1.5
20063740;284682;7;28.03.2024 00:00;17530;17280;250;1.4
20063738;284386;7;28.03.2024 00:00;53020;48386;4634;4.2
20063737;272190;7;28.03.2024 00:00;64984;62210;2774;5.2
20063593;286365;7;02.04.2024 00:00;373745;354962;18783;30.5
20064066;287235;7;02.04.2024 00:00;2;2;0;3.5
20063741;286121;7;02.04.2024 00:00;16846;12674;4172;1.1
20063911;280466;7;03.04.2024 00:00;165575;149184;16391;12.9
20064156;286877;7;04.04.2024 00:00;145244;129026;16218;11.0
20064155;286751;7;05.04.2024 00:00;57554;48387;9167;4.4
20064158;286974;7;05.04.2024 00:00;25506;17280;8226;1.6
20064157;286893;7;05.04.2024 00:00;43196;37299;5897;3.3
20064149;285673;7;05.04.2024 00:00;42318;38016;4302;3.3
20064151;285843;7;06.04.2024 00:00;66716;59760;6956;5.4
20064150;285843;7;06.04.2024 00:00;57164;51842;5322;4.6
20064142;280465;7;06.04.2024 00:00;116830;106562;10268;9.5
20064152;286132;7;07.04.2024 00:00;49992;44640;5352;4.2
20064159;286978;7;07.04.2024 00:00;19002;18290;712;1.7
20064209;;7;07.04.2024 00:00;0;0;0;0.0
20064182;285825;7;07.04.2024 00:00;7000;7000;0;2.2
20064272;;7;08.04.2024 00:00;0;0;0;0.0
20064154;286500;7;08.04.2024 00:00;277638;259203;18435;23.2
20064144;284882;7;08.04.2024 00:00;19801;13826;5975;1.2
20064160;287045;7;09.04.2024 00:00;38670;34562;4108;3.0
20064161;287053;7;09.04.2024 00:00;18573;17282;1291;1.6
20064146;285286;7;09.04.2024 00:00;57537;42624;14913;4.1
20064148;285382;7;09.04.2024 00:00;17175;16706;469;1.5
20064147;285288;7;10.04.2024 00:00;28000;23040;4960;2.8
20064143;284428;7;10.04.2024 00:00;19502;14402;5100;1.4
20064145;284991;7;10.04.2024 00:00;150873;135218;15655;13.1
20064153;286327;7;11.04.2024 00:00;394374;365762;28612;32.6
20064331;286599;7;12.04.2024 00:00;163507;149186;14321;13.1
20064380;286365;7;13.04.2024 00:00;198981;189506;9475;16.6
20064379;284677;7;14.04.2024 00:00;208316;200450;7866;17.7
20064637;287052;7;15.04.2024 00:00;35686;30816;4870;2.7
20064377;279136;7;15.04.2024 00:00;54816;48386;6430;4.2
20064386;275877;7;15.04.2024 00:00;539428;495938;43490;43.5
20064492;286859;7;17.04.2024 00:00;26582;24194;2388;2.2
20064491;277192;7;17.04.2024 00:00;26337;24194;2143;2.2
20064539;287203;7;18.04.2024 00:00;31199;28224;2975;2.5
20064531;276322;7;18.04.2024 00:00;45278;40322;4956;3.5
20064540;287216;7;18.04.2024 00:00;31570;28224;3346;2.5
20064535;283627;7;18.04.2024 00:00;69266;57603;11663;5.2
20064537;286337;7;18.04.2024 00:00;29613;28802;811;2.5
20064538;287184;7;19.04.2024 00:00;30837;28658;2179;2.6
20064534;279156;7;19.04.2024 00:00;41510;32259;9251;2.8
20064536;285384;7;19.04.2024 00:00;30902;24192;6710;2.1
20064530;272565;7;19.04.2024 00:00;135774;129026;6748;10.4
20064533;279144;7;20.04.2024 00:00;39051;33986;5065;2.8
20064532;277213;7;20.04.2024 00:00;57739;46944;10795;4.4
20064627;278180;7;20.04.2024 00:00;9402;4060;5342;0.4
20064628;286327;7;20.04.2024 00:00;176955;158258;18697;14.1
20064629;286365;7;21.04.2024 00:00;59454;48674;10780;4.3
20064631;287274;7;22.04.2024 00:00;55800;52418;3382;4.5
20064630;287273;7;22.04.2024 00:00;62486;56448;6038;5.0
20064737;286979;7;22.04.2024 00:00;133857;120962;12895;10.4
20064739;286979;7;23.04.2024 00:00;124085;120960;3125;10.2
20064738;286979;7;23.04.2024 00:00;126012;121106;4906;9.7
20064740;286979;7;24.04.2024 00:00;128066;120962;7104;10.0
20064845;286979;7;24.04.2024 00:00;123866;120960;2906;10.4
20064844;286979;7;25.04.2024 00:00;124746;120962;3784;10.3
20064936;286979;7;25.04.2024 00:00;126686;120960;5726;10.4
20064937;286979;7;26.04.2024 00:00;126186;121106;5080;9.8
20064980;286979;7;26.04.2024 00:00;126006;120960;5046;10.5
20064981;286979;7;27.04.2024 00:00;125542;120962;4580;10.2
20064983;286979;7;27.04.2024 00:00;128112;120960;7152;10.4
20064982;286979;7;28.04.2024 00:00;129333;120960;8373;10.2
20064984;286980;7;28.04.2024 00:00;195313;181443;13870;14.6
20065090;286980;7;29.04.2024 00:00;191920;181442;10478;15.0
20065091;286980;7;30.04.2024 00:00;185791;181442;4349;15.2
20065123;286980;7;30.04.2024 00:00;186350;181440;4910;15.2
20065340;286980;7;01.05.2024 00:00;190966;181442;9524;14.8
20065190;287295;7;02.05.2024 00:00;188867;171648;17219;14.1
20065281;287351;7;02.05.2024 00:00;64686;55731;8955;4.9
20065345;280466;7;03.05.2024 00:00;208220;189506;18714;15.2
20065475;287346;7;04.05.2024 00:00;108630;104834;3796;8.3
20065346;285033;7;04.05.2024 00:00;109268;100802;8466;8.2
20065280;284073;7;04.05.2024 00:00;28753;24195;4558;2.0
20065343;270325;7;05.05.2024 00:00;79443;65522;13921;6.0
20065348;287344;7;05.05.2024 00:00;17864;16130;1734;1.4
20065344;279144;7;05.05.2024 00:00;145372;129602;15770;10.5
20065591;270339;7;06.05.2024 00:00;59646;52992;6654;4.6
20065347;286487;7;06.05.2024 00:00;83283;75314;7969;6.0
20065419;287486;7;07.05.2024 00:00;1730;1730;0;6.2
20065418;287485;7;07.05.2024 00:00;7274;7274;0;2.0
20065410;286500;7;07.05.2024 00:00;44631;38016;6615;3.3
20065500;286365;7;07.05.2024 00:00;374973;342722;32251;29.2
20065408;284214;7;09.05.2024 00:00;99379;92736;6643;7.7
20065474;286599;7;09.05.2024 00:00;112202;104834;7368;8.5
20065540;286859;7;10.05.2024 00:00;29491;24194;5297;2.1
20065539;284075;7;10.05.2024 00:00;126176;116930;9246;9.6
20065538;279136;7;10.05.2024 00:00;107778;100802;6976;8.4
20065598;286622;7;11.05.2024 00:00;150918;141123;9795;11.9
20065592;273568;7;11.05.2024 00:00;50304;48384;1920;4.0
20065597;284063;7;12.05.2024 00:00;111883;96770;15113;8.6
20065599;286751;7;12.05.2024 00:00;31708;24194;7514;2.2
20065600;286818;7;12.05.2024 00:00;32934;20448;12486;1.9
20065593;279135;7;12.05.2024 00:00;54253;44352;9901;3.9
20065681;275764;7;13.05.2024 00:00;17455;12096;5359;1.0
20065684;284050;7;13.05.2024 00:00;68721;64514;4207;5.3
20065594;279156;7;13.05.2024 00:00;172611;157248;15363;13.3
20065683;283530;7;14.05.2024 00:00;22588;20160;2428;1.6
20065685;286802;7;14.05.2024 00:00;25305;24192;1113;2.0
20065706;286980;7;14.05.2024 00:00;192108;181440;10668;15.2
20065744;286980;7;15.05.2024 00:00;185300;181442;3858;14.9
20065745;286980;7;16.05.2024 00:00;190483;181442;9041;15.4
20065746;287052;7;16.05.2024 00:00;24854;20163;4691;1.9
20065891;285189;7;16.05.2024 00:00;53520;52418;1102;4.3
20065895;286599;7;17.05.2024 00:00;45635;40176;5459;3.7
20065890;284677;7;17.05.2024 00:00;101095;93026;8069;7.7
20065893;286365;7;17.05.2024 00:00;15277;12096;3181;1.1
20066172;284676;7;17.05.2024 00:00;81536;76610;4926;6.6
20066171;272189;7;18.05.2024 00:00;89496;80640;8856;6.9
20065892;286160;7;18.05.2024 00:00;29250;25920;3330;2.2
20065887;284380;7;18.05.2024 00:00;53021;52417;604;4.4
20065888;284386;7;18.05.2024 00:00;21870;17282;4588;1.6
20065897;287541;7;19.05.2024 00:00;188189;172802;15387;14.7
20065886;276324;7;19.05.2024 00:00;35664;32690;2974;3.0
20065936;287537;7;19.05.2024 00:00;53502;50114;3388;4.5
20065935;285843;7;20.05.2024 00:00;59529;50689;8840;4.4
20065934;285126;7;20.05.2024 00:00;332739;302123;30616;27.0
20065964;284853;7;22.05.2024 00:00;18002;13826;4176;1.4
20065963;279032;7;22.05.2024 00:00;65268;55155;10113;4.9
20066033;284073;7;22.05.2024 00:00;35124;26497;8627;2.2
20066034;284383;7;22.05.2024 00:00;22642;21602;1040;1.9
20066032;279144;7;23.05.2024 00:00;110211;97634;12577;7.9
20066036;287538;7;23.05.2024 00:00;28857;24194;4663;1.9
20066029;272565;7;23.05.2024 00:00;118449;108868;9581;8.5
20066059;285653;7;24.05.2024 00:00;29218;24192;5026;2.0
20066058;284264;7;24.05.2024 00:00;92923;81792;11131;6.6
20066061;286979;7;24.05.2024 00:00;136270;120960;15310;10.2
20066060;286979;7;25.05.2024 00:00;129600;120960;8640;10.1
20066183;286979;7;25.05.2024 00:00;131255;120960;10295;10.0
20066182;286979;7;26.05.2024 00:00;124381;120962;3419;10.0
20066184;287184;7;26.05.2024 00:00;64538;57602;6936;5.0
20066180;286500;7;26.05.2024 00:00;31208;28802;2406;2.4
20066179;286337;7;27.05.2024 00:00;61485;54723;6762;4.8
20066178;286327;7;27.05.2024 00:00;113687;103536;10151;9.1
20066181;286611;7;28.05.2024 00:00;86215;83524;2691;7.0
20066177;285286;7;28.05.2024 00:00;48810;42482;6328;3.6
20066176;284454;7;28.05.2024 00:00;29117;25058;4059;2.2
20066227;279717;7;28.05.2024 00:00;78714;65088;13626;5.8
20066454;285843;7;29.05.2024 00:00;67890;57600;10290;5.2
20066228;280465;7;29.05.2024 00:00;29726;25922;3804;2.4
20066459;287351;7;29.05.2024 00:00;152168;139250;12918;12.7
20066231;287346;7;30.05.2024 00:00;270240;258048;12192;20.8
20066461;287743;7;31.05.2024 00:00;19262;17282;1980;1.5
20066460;287742;7;31.05.2024 00:00;42260;38016;4244;3.2
20066458;287274;7;31.05.2024 00:00;55408;48387;7021;3.9
20066395;284189;7;31.05.2024 00:00;67360;65666;1694;5.5
20066456;286599;7;01.06.2024 00:00;61656;56448;5208;4.7
20066453;285189;7;01.06.2024 00:00;46270;44352;1918;3.6
20066452;284214;7;01.06.2024 00:00;52974;48098;4876;3.9
20066455;286365;7;01.06.2024 00:00;248978;237888;11090;19.0
20066462;287748;7;02.06.2024 00:00;56674;52418;4256;4.4
20066450;282124;7;02.06.2024 00:00;47454;44354;3100;3.6
20066451;284075;7;03.06.2024 00:00;133210;104832;28378;8.9
20066397;285288;7;03.06.2024 00:00;34531;28801;5730;2.5
20066457;287203;7;03.06.2024 00:00;29000;26496;2504;2.2
20066466;286327;7;03.06.2024 00:00;319500;299523;19977;25.5
20066465;284681;7;03.06.2024 00:00;31549;28800;2749;2.5
20066464;283627;7;05.06.2024 00:00;116606;112320;4286;9.4
20066745;283545;7;05.06.2024 00:00;41039;35283;5756;2.8
20066750;285033;7;05.06.2024 00:00;271124;261074;10050;21.2
20066463;270324;7;06.06.2024 00:00;25729;23042;2687;2.0
20066747;284050;7;07.06.2024 00:00;55316;48386;6930;4.0
20066330;286487;7;07.06.2024 00:00;251450;234722;16728;19.0
20066744;282215;7;07.06.2024 00:00;27135;24194;2941;2.2
20066743;279156;7;08.06.2024 00:00;261965;245954;16011;19.7
20066749;284485;7;09.06.2024 00:00;27001;24194;2807;2.2
20066827;287601;7;09.06.2024 00:00;30705;29952;753;2.4
20066617;285842;7;09.06.2024 00:00;243300;221474;21826;17.8
20066751;287081;7;10.06.2024 00:00;14783;14783;0;3.6
20066976;287485;7;10.06.2024 00:00;8201;2161;6040;0.5
20066977;287486;7;10.06.2024 00:00;8968;2160;6808;0.2
20066748;284214;7;11.06.2024 00:00;55948;52419;3529;4.3
20066800;287830;7;11.06.2024 00:00;33000;28224;4776;2.4
20066663;286980;7;11.06.2024 00:00;195226;181442;13784;15.1
20066862;286980;7;12.06.2024 00:00;186775;181442;5333;14.8
20066924;286979;7;12.06.2024 00:00;134049;121250;12799;9.7
20066953;286979;7;13.06.2024 00:00;131166;120962;10204;10.2
20066952;286979;7;13.06.2024 00:00;129376;120960;8416;10.2
20067030;286500;7;14.06.2024 00:00;321240;303984;17256;24.6
20066954;287606;7;14.06.2024 00:00;20060;17280;2780;1.4
20067027;284882;7;15.06.2024 00:00;54582;51696;2886;4.4
20067033;287053;7;15.06.2024 00:00;20000;18000;2000;1.4
20067031;287045;7;15.06.2024 00:00;35910;34562;1348;2.9
20067028;285382;7;16.06.2024 00:00;55002;51842;3160;4.2
20067029;286121;7;16.06.2024 00:00;55590;51840;3750;4.3
20067026;272190;7;16.06.2024 00:00;56427;51844;4583;4.3
20067123;284991;7;16.06.2024 00:00;89862;77761;12101;6.7
20067032;287743;7;16.06.2024 00:00;39987;38018;1969;3.1
20067125;287184;7;17.06.2024 00:00;39672;40322;-650;3.4
20067336;272565;7;17.06.2024 00:00;13628;10513;3115;1.2
20067439;279019;7;17.06.2024 00:00;106762;96772;9990;8.1
20067440;279156;7;18.06.2024 00:00;46125;39744;6381;3.5
20067337;284051;7;18.06.2024 00:00;25468;24481;987;2.2
20067441;284048;7;18.06.2024 00:00;35000;25776;9224;2.3
20067321;286751;7;18.06.2024 00:00;112198;103682;8516;8.3
20067366;286132;7;19.06.2024 00:00;50136;40032;10104;3.8
20067252;284677;7;19.06.2024 00:00;222150;200880;21270;16.7
20067444;287999;7;20.06.2024 00:00;98200;96480;1720;8.6
20067463;285825;7;21.06.2024 00:00;7954;7954;0;2.4
20067338;287999;7;21.06.2024 00:00;239520;222771;16749;19.2
20067124;286599;7;22.06.2024 00:00;224241;209524;14717;16.0
20067745;279032;7;24.06.2024 00:00;108699;101378;7321;8.9
20067747;286132;7;25.06.2024 00:00;28629;23043;5586;2.0
20067746;279156;7;25.06.2024 00:00;208450;194256;14194;15.9
20067748;286857;7;26.06.2024 00:00;43002;36291;6711;3.1
20067749;288092;7;26.06.2024 00:00;33613;30674;2939;2.5
20067540;284677;7;27.06.2024 00:00;225682;214274;11408;17.8
20067320;285285;7;27.06.2024 00:00;26402;20163;6239;2.0
20067442;286980;7;28.06.2024 00:00;192361;181443;10918;15.5
20067443;286980;7;29.06.2024 00:00;195496;180146;15350;15.5
20067520;287997;7;01.07.2024 00:00;109144;104260;4884;9.0
20067318;279136;7;01.07.2024 00:00;19502;20162;-660;1.6
20067857;288096;7;01.07.2024 00:00;58521;56449;2072;4.8
20067855;284676;7;01.07.2024 00:00;49812;48386;1426;4.0
20067652;286123;7;01.07.2024 00:00;21892;20162;1730;1.7
20067856;287999;7;02.07.2024 00:00;202642;197570;5072;16.8
20067958;286365;7;03.07.2024 00:00;195820;189504;6316;16.3
20067957;285189;7;03.07.2024 00:00;29877;24194;5683;2.3
20067959;287052;7;03.07.2024 00:00;33969;28226;5743;2.4
20067960;287216;7;04.07.2024 00:00;21923;20162;1761;1.8
20067955;284189;7;04.07.2024 00:00;33586;26208;7378;2.4
20067126;287839;7;04.07.2024 00:00;122672;115634;7038;10.0
20067737;276324;7;04.07.2024 00:00;20020;17280;2740;1.5
20068076;287742;7;05.07.2024 00:00;51434;48386;3048;4.0
20068079;284389;7;05.07.2024 00:00;19748;15842;3906;1.5
20068197;286979;7;05.07.2024 00:00;126350;120960;5390;10.0
20068198;286979;7;05.07.2024 00:00;130431;120962;9469;10.3
20068199;286979;7;08.07.2024 00:00;122131;120960;1171;10.2
20068201;286980;7;08.07.2024 00:00;192954;181442;11512;15.3
20068200;286980;7;09.07.2024 00:00;191994;181443;10551;14.9
20068202;286980;7;10.07.2024 00:00;187756;181296;6460;14.8
20068503;;7;10.07.2024 00:00;0;0;0;0.0
20068504;;7;11.07.2024 00:00;0;0;0;0.0
20068075;287203;7;11.07.2024 00:00;57740;44355;13385;4.0
20068502;285825;7;11.07.2024 00:00;11651;11651;0;6.0
20068073;272189;7;11.07.2024 00:00;52706;48385;4321;4.0
20068077;287830;7;11.07.2024 00:00;26475;24192;2283;2.0
20068078;288051;7;12.07.2024 00:00;59861;56450;3411;4.8
20068074;286160;7;12.07.2024 00:00;26595;24192;2403;2.0
20068469;288240;7;12.07.2024 00:00;90021;77761;12260;6.6
20068454;279717;7;13.07.2024 00:00;66912;61922;4990;5.3
20068468;287905;7;13.07.2024 00:00;22650;20736;1914;1.7
20068462;284853;7;13.07.2024 00:00;38093;37874;219;3.1
20068466;287537;7;13.07.2024 00:00;24855;18435;6420;1.6
20068465;286978;7;13.07.2024 00:00;19502;18434;1068;1.5
20068464;286893;7;13.07.2024 00:00;19593;14690;4903;1.4
20068636;284073;7;13.07.2024 00:00;26066;24193;1873;3.3
20068633;285843;7;14.07.2024 00:00;90651;80642;10009;6.8
20068453;279144;7;14.07.2024 00:00;137173;127872;9301;10.5
20068456;282215;7;15.07.2024 00:00;29078;24192;4886;2.0
20068458;284050;7;15.07.2024 00:00;78513;72578;5935;5.9
20068463;285384;7;15.07.2024 00:00;52393;48386;4007;4.0
20068455;280473;7;15.07.2024 00:00;53596;48386;5210;4.2
20068467;287601;7;15.07.2024 00:00;25649;20163;5486;1.6
20068457;283530;7;16.07.2024 00:00;53502;48386;5116;4.1
20068459;284051;7;16.07.2024 00:00;25110;24192;918;1.9
20068481;284485;7;16.07.2024 00:00;53580;48384;5196;3.8
20068461;284264;7;16.07.2024 00:00;50006;45795;4211;4.0
20068562;276322;7;16.07.2024 00:00;67874;56450;11424;5.2
20068592;288090;7;17.07.2024 00:00;31230;28224;3006;2.3
20068590;285379;7;17.07.2024 00:00;17460;16128;1332;1.3
20068635;286365;7;17.07.2024 00:00;52799;48098;4701;3.9
20068589;284683;7;17.07.2024 00:00;26160;24192;1968;2.0
20068563;284214;7;17.07.2024 00:00;80267;75168;5099;6.3
20068794;288096;7;17.07.2024 00:00;50002;48386;1616;4.0
20068632;283627;7;18.07.2024 00:00;22003;20163;1840;1.8
20068634;286327;7;18.07.2024 00:00;391186;362450;28736;31.2
20069333;276322;7;05.08.2024 00:00;21002;16130;4872;1.2
20069336;287273;7;05.08.2024 00:00;59401;48386;11015;4.0
20069335;284075;7;05.08.2024 00:00;132425;122117;10308;11.4
20069334;277192;7;06.08.2024 00:00;27502;24194;3308;2.1
20069505;284676;7;06.08.2024 00:00;55652;52418;3234;4.4
20069518;287997;7;06.08.2024 00:00;22902;22178;724;1.8
20069509;285379;7;06.08.2024 00:00;12346;12096;250;1.1
20069512;286365;7;06.08.2024 00:00;166210;157248;8962;13.2
20069520;288090;7;06.08.2024 00:00;28292;24194;4098;2.1
20069519;287999;7;07.08.2024 00:00;84072;76610;7462;6.5
20069514;287052;7;07.08.2024 00:00;26232;24194;2038;2.1
20069502;284214;7;07.08.2024 00:00;45736;44352;1384;3.7
20069521;288611;7;08.08.2024 00:00;54002;52130;1872;4.5
20069501;284189;7;08.08.2024 00:00;40122;38018;2104;3.3
20069515;287053;7;08.08.2024 00:00;14262;13826;436;1.4
20069517;287839;7;08.08.2024 00:00;18736;17280;1456;1.4
20069503;284389;7;08.08.2024 00:00;37110;34560;2550;2.9
20069506;284682;7;08.08.2024 00:00;18180;17280;900;1.4
20069504;284428;7;09.08.2024 00:00;15530;14402;1128;1.4
20069516;287743;7;09.08.2024 00:00;12000;11664;336;1.0
20069508;285288;7;09.08.2024 00:00;27002;25922;1080;2.4
20069513;287045;7;09.08.2024 00:00;16000;14112;1888;1.2
20069500;283627;7;09.08.2024 00:00;29196;25920;3276;2.5
20069510;286327;7;09.08.2024 00:00;27442;19010;8432;1.8
20069511;286337;7;09.08.2024 00:00;88934;84096;4838;8.1
20069507;284991;7;10.08.2024 00:00;44378;39458;4920;3.5
20069532;270325;7;10.08.2024 00:00;94338;85682;8656;8.0
20069544;287344;7;10.08.2024 00:00;15800;12096;3704;1.2
20069539;284063;7;11.08.2024 00:00;56000;51696;4304;4.7
20069605;286132;7;11.08.2024 00:00;31273;20163;11110;2.0
20069548;287612;7;11.08.2024 00:00;27920;28226;-306;2.5
20069540;285033;7;11.08.2024 00:00;127186;112898;14288;9.7
20069546;287462;7;12.08.2024 00:00;30900;24193;6707;2.1
20069536;279135;7;12.08.2024 00:00;59182;56450;2732;4.6
20069547;287602;7;13.08.2024 00:00;19846;14258;5588;1.2
20069543;286819;7;13.08.2024 00:00;22332;17282;5050;1.5
20069545;287351;7;13.08.2024 00:00;121230;109296;11934;9.5
20069533;270339;7;13.08.2024 00:00;55628;51843;3785;4.3
20069538;283976;7;14.08.2024 00:00;24523;20163;4360;1.7
20069534;272565;7;14.08.2024 00:00;118797;104834;13963;9.0
20069541;285842;7;14.08.2024 00:00;46356;44354;2002;3.6
20069542;286487;7;15.08.2024 00:00;178807;166898;11909;13.3
20069535;279019;7;15.08.2024 00:00;24330;24192;138;2.0
20069537;279156;7;16.08.2024 00:00;55956;50976;4980;4.1
20069926;284677;7;17.08.2024 00:00;267035;241922;25113;20.3
20069927;284677;7;18.08.2024 00:00;219938;207363;12575;17.4
20070011;284677;7;19.08.2024 00:00;76913;76036;877;6.2
20070012;286599;7;20.08.2024 00:00;125751;104834;20917;9.0
20070051;285379;7;20.08.2024 00:00;18032;17858;174;1.4
20070118;287612;7;20.08.2024 00:00;52162;48387;3775;3.9
20070050;285202;7;20.08.2024 00:00;105896;98930;6966;8.1
20070052;287346;7;21.08.2024 00:00;131652;119667;11985;9.7
20070116;285843;7;21.08.2024 00:00;32602;27075;5527;2.6
20070117;287351;7;21.08.2024 00:00;21093;17282;3811;1.5
20070119;;7;22.08.2024 00:00;0;0;0;0.0
20070199;286982;7;22.08.2024 00:00;367632;332904;34728;25.9
20070367;286982;7;23.08.2024 00:00;399350;332642;66708;25.6
20070368;286982;7;27.08.2024 00:00;350190;332642;17548;24.5
20070369;286982;7;28.08.2024 00:00;353743;332642;21101;24.6
20070200;286982;7;29.08.2024 00:00;348938;332642;16296;25.0
20070120;;7;30.08.2024 00:00;0;0;0;0.0
20070284;286327;7;30.08.2024 00:00;425901;368498;57403;32.2
20070283;284428;7;03.09.2024 00:00;14963;14402;561;1.2
20070370;286611;7;03.09.2024 00:00;93816;86400;7416;7.4
20070371;287045;7;04.09.2024 00:00;21249;15264;5985;1.3
20070470;286979;7;04.09.2024 00:00;131731;120962;10769;10.7
20070598;286979;7;04.09.2024 00:00;126868;120962;5906;10.2
20070597;286979;7;05.09.2024 00:00;125518;120962;4556;9.9
20070599;286979;7;05.09.2024 00:00;126941;120962;5979;10.2
20070600;286979;7;06.09.2024 00:00;127957;120963;6994;10.1
20070231;286980;7;06.09.2024 00:00;196541;181442;15099;15.3
20070637;286980;7;09.09.2024 00:00;190913;181442;9471;15.0
20070636;286980;7;09.09.2024 00:00;196662;181442;15220;15.2
20070638;286980;7;10.09.2024 00:00;189354;181442;7912;15.3
20070232;286980;7;11.09.2024 00:00;191238;181440;9798;15.4
20070880;288782;7;11.09.2024 00:00;33170;30963;2207;2.6
20070927;288832;7;12.09.2024 00:00;59715;103395;-43680;4.9
20070879;288051;7;12.09.2024 00:00;21002;19874;1128;1.6
20070877;283627;7;12.09.2024 00:00;39121;31680;7441;2.7
20070937;287537;7;12.09.2024 00:00;40402;31107;9295;2.7
20070948;279866;7;13.09.2024 00:00;5452;5762;-310;0.5
20071218;286751;7;13.09.2024 00:00;56897;44354;12543;4.0
20070994;287346;7;13.09.2024 00:00;159947;149185;10762;13.0
20070995;287830;7;16.09.2024 00:00;30991;24194;6797;2.1
20070993;287203;7;16.09.2024 00:00;25134;24194;940;2.1
20070985;284683;7;16.09.2024 00:00;26596;24194;2402;2.1
20070990;286160;7;16.09.2024 00:00;28882;24194;4688;2.1
20070996;287997;7;16.09.2024 00:00;57368;52416;4952;4.6
20070987;285379;7;16.09.2024 00:00;53476;48386;5090;4.2
20071048;284676;7;17.09.2024 00:00;54670;52416;2254;4.7
20071046;284075;7;17.09.2024 00:00;140000;124992;15008;11.1
20071049;285189;7;18.09.2024 00:00;104387;100803;3584;8.4
20071047;284454;7;18.09.2024 00:00;26300;20160;6140;1.8
20071126;287999;7;18.09.2024 00:00;83141;76609;6532;6.6
20071124;287052;7;18.09.2024 00:00;29907;24194;5713;2.3
20071123;286365;7;19.09.2024 00:00;410082;387077;23005;33.2
20071250;284214;7;20.09.2024 00:00;168705;161138;7567;14.2
20071254;284681;7;21.09.2024 00:00;31762;25922;5840;2.3
20071317;285288;7;21.09.2024 00:00;27842;25922;1920;2.2
20071315;284428;7;21.09.2024 00:00;44240;40320;3920;3.5
20071316;284991;7;22.09.2024 00:00;32000;28800;3200;2.4
20071318;286337;7;22.09.2024 00:00;59828;54000;5828;4.8
20071319;286500;7;22.09.2024 00:00;65987;58610;7377;5.2
20071314;284189;7;22.09.2024 00:00;68776;62210;6566;5.4
20071322;288832;7;23.09.2024 00:00;94089;86400;7689;7.6
20071323;288871;7;23.09.2024 00:00;21020;17280;3740;1.6
20071321;288129;7;23.09.2024 00:00;190863;165888;24975;14.7
20071361;285382;7;24.09.2024 00:00;16500;13824;2676;1.3
20071362;286121;7;24.09.2024 00:00;20850;17280;3570;1.5
20071363;287742;7;24.09.2024 00:00;68210;63650;4560;5.5
20071364;287839;7;25.09.2024 00:00;84599;82944;1655;7.2
20071402;279136;7;25.09.2024 00:00;83023;72576;10447;6.3
20071403;286622;7;25.09.2024 00:00;158040;149186;8854;12.5
20071404;287273;7;26.09.2024 00:00;50920;44355;6565;4.0
20071440;284677;7;26.09.2024 00:00;24254;20737;3517;1.8
20071405;288611;7;26.09.2024 00:00;24410;25344;-934;2.2
20071482;285286;7;26.09.2024 00:00;88210;80642;7568;6.7
20071480;279135;7;27.09.2024 00:00;47668;40323;7345;3.8
20071484;287600;7;27.09.2024 00:00;44833;38017;6816;3.3
20071481;284383;7;27.09.2024 00:00;29401;24195;5206;2.0
20071483;287346;7;28.09.2024 00:00;168287;154368;13919;13.2
20071529;285126;7;28.09.2024 00:00;229359;203003;26356;17.6
20071530;285842;7;29.09.2024 00:00;276922;254019;22903;20.6
20071547;286857;7;01.10.2024 00:00;93521;88704;4817;7.5
20071531;287538;7;01.10.2024 00:00;46072;43490;2582;3.6
20071606;284485;7;02.10.2024 00:00;80160;72579;7581;5.9
20071546;286487;7;02.10.2024 00:00;74780;72576;2204;6.0
20071608;287601;7;02.10.2024 00:00;30722;29090;1632;2.6
20071609;288259;7;02.10.2024 00:00;33029;25344;7685;2.1
20071604;283530;7;03.10.2024 00:00;41365;30816;10549;2.4
20071605;284051;7;03.10.2024 00:00;30933;30962;-29;3.3
20071672;284050;7;03.10.2024 00:00;26205;24194;2011;2.0
20071671;282215;7;03.10.2024 00:00;26442;24194;2248;2.0
20071670;279144;7;03.10.2024 00:00;238381;220467;17914;18.4
20071674;288875;7;04.10.2024 00:00;75727;65521;10206;5.9
20071793;286979;7;05.10.2024 00:00;131300;120960;10340;9.9
20071794;286979;7;05.10.2024 00:00;131125;120964;10161;10.1
20071795;286979;7;07.10.2024 00:00;124031;120962;3069;10.2
20071796;286979;7;08.10.2024 00:00;124611;120960;3651;10.2
20071797;286979;7;08.10.2024 00:00;127202;120962;6240;10.0
20071798;286979;7;08.10.2024 00:00;124300;120960;3340;9.9
20071607;286980;7;09.10.2024 00:00;197502;181442;16060;15.3
20071791;286327;7;10.10.2024 00:00;622871;550944;71927;49.2
20071792;286500;7;14.10.2024 00:00;185678;168192;17486;14.6
20072153;284682;7;14.10.2024 00:00;20232;17281;2951;1.5
20072154;285382;7;15.10.2024 00:00;16700;13824;2876;1.2
20072156;286893;7;15.10.2024 00:00;36309;31107;5202;2.9
20072159;287537;7;15.10.2024 00:00;22276;17280;4996;1.5
20072155;286819;7;15.10.2024 00:00;22578;19008;3570;1.8
20072157;286974;7;15.10.2024 00:00;19819;19008;811;1.6
20072158;287351;7;15.10.2024 00:00;240093;220033;20060;18.6
20072163;286982;7;17.10.2024 00:00;366935;332644;34291;24.6
20072161;;7;17.10.2024 00:00;0;0;0;0.0
20072164;286982;7;18.10.2024 00:00;345276;332642;12634;24.7
20072162;;7;19.10.2024 00:00;0;0;0;0.0
20072350;286857;7;19.10.2024 00:00;36429;30961;5468;2.6
20072351;288714;7;19.10.2024 00:00;37760;28226;9534;2.4
20072349;279156;7;20.10.2024 00:00;204174;194402;9772;15.6
20072384;288240;7;21.10.2024 00:00;80333;76608;3725;6.8
20072379;284063;7;21.10.2024 00:00;34886;26496;8390;2.3
20072385;288572;7;21.10.2024 00:00;77997;71426;6571;5.9
20072382;285843;7;21.10.2024 00:00;54772;41761;13011;3.7
20072380;284991;7;22.10.2024 00:00;77163;69121;8042;5.9
20072383;287184;7;22.10.2024 00:00;69586;66243;3343;5.6
20072474;286337;7;22.10.2024 00:00;79228;69122;10106;5.6
20072378;283627;7;23.10.2024 00:00;71451;69122;2329;5.7
20072381;285288;7;23.10.2024 00:00;33393;28802;4591;2.4
20072510;286611;7;24.10.2024 00:00;178282;160706;17576;13.5
20072601;287742;7;25.10.2024 00:00;62884;50688;12196;4.0
20072599;284189;7;25.10.2024 00:00;58420;48384;10036;4.3
20072600;284882;7;25.10.2024 00:00;18460;17280;1180;1.6
20072631;288870;7;25.10.2024 00:00;34380;28226;6154;2.6
20072630;288611;7;26.10.2024 00:00;86401;78626;7775;6.6
20072625;287052;7;28.10.2024 00:00;56909;48098;8811;4.1
20072833;286365;7;28.10.2024 00:00;328874;298368;30506;25.7
20072624;286599;7;28.10.2024 00:00;51782;49250;2532;4.4
20072629;288051;7;29.10.2024 00:00;28768;26498;2270;2.3
20072683;284075;7;30.10.2024 00:00;128781;112896;15885;9.9
20072832;285189;7;30.10.2024 00:00;30022;24194;5828;2.2
20072626;287203;7;30.10.2024 00:00;30674;28224;2450;2.6
20072627;287273;7;30.10.2024 00:00;29929;28224;1705;2.5
20072628;287997;7;31.10.2024 00:00;85312;72576;12736;6.4
20072844;286160;7;31.10.2024 00:00;25240;24192;1048;2.1
20072684;284454;7;31.10.2024 00:00;33550;28225;5325;2.6
20072685;285379;7;31.10.2024 00:00;21942;20160;1782;1.9
20072682;282124;7;31.10.2024 00:00;31088;28224;2864;2.6
20072843;284683;7;01.11.2024 00:00;28850;24194;4656;2.3
20072842;284676;7;01.11.2024 00:00;47761;44358;3403;4.1
20073093;279156;7;01.11.2024 00:00;65311;57600;7711;4.6
20072686;287346;7;01.11.2024 00:00;414714;392544;22170;31.7
20073358;288257;7;05.11.2024 00:00;40000;29808;10192;2.5
20073136;286751;7;05.11.2024 00:00;30275;25056;5219;2.1
20073142;287537;7;05.11.2024 00:00;24113;17282;6831;1.6
20073140;286974;7;05.11.2024 00:00;18052;17282;770;1.4
20073138;286819;7;05.11.2024 00:00;20905;17282;3623;1.6
20073139;286893;7;05.11.2024 00:00;22946;17282;5664;1.6
20073137;286818;7;06.11.2024 00:00;16258;13824;2434;1.3
20073145;287839;7;06.11.2024 00:00;43859;34560;9299;3.2
20073134;286121;7;06.11.2024 00:00;15935;13824;2111;1.2
20073132;284389;7;06.11.2024 00:00;39933;38018;1915;3.3
20073133;285382;7;06.11.2024 00:00;19190;17280;1910;1.4
20073143;287742;7;06.11.2024 00:00;36002;34562;1440;2.9
20073130;276324;7;06.11.2024 00:00;31605;31104;501;2.7
20073144;287743;7;06.11.2024 00:00;19002;17282;1720;1.5
20073135;286500;7;07.11.2024 00:00;206647;196850;9797;17.1
20073147;288832;7;07.11.2024 00:00;35116;27648;7468;2.3
20073141;287053;7;08.11.2024 00:00;43933;38016;5917;3.6
20073131;284189;7;08.11.2024 00:00;73579;69986;3593;6.0
20073146;287999;7;08.11.2024 00:00;153139;145154;7985;12.6
20073248;286599;7;09.11.2024 00:00;93991;83522;10469;7.3
20073247;284214;7;11.11.2024 00:00;101989;96768;5221;8.4
20073249;287748;7;11.11.2024 00:00;53000;48384;4616;4.0
20073246;282124;7;12.11.2024 00:00;26284;24194;2090;2.1
20073250;287830;7;12.11.2024 00:00;30386;26496;3890;2.4
20073251;288051;7;12.11.2024 00:00;24502;23906;596;2.1
20073379;287273;7;12.11.2024 00:00;31340;25920;5420;2.3
20073252;288090;7;12.11.2024 00:00;29220;26496;2724;2.6
20073377;276322;7;12.11.2024 00:00;28300;28224;76;2.5
20073381;289012;7;12.11.2024 00:00;61231;52418;8813;4.4
20073493;284050;7;13.11.2024 00:00;82028;76610;5418;6.4
20073380;289011;7;13.11.2024 00:00;29851;28226;1625;2.3
20073492;279019;7;13.11.2024 00:00;23196;20160;3036;1.6
20073494;286915;7;13.11.2024 00:00;18543;16128;2415;1.3
20073418;286487;7;13.11.2024 00:00;212161;201602;10559;15.6
20073495;288847;7;13.11.2024 00:00;35896;28224;7672;2.2
20073419;286857;7;14.11.2024 00:00;140807;128882;11925;9.7
20073567;288092;7;15.11.2024 00:00;24862;20162;4700;1.6
20073569;288856;7;15.11.2024 00:00;60000;52416;7584;4.3
20073566;287601;7;15.11.2024 00:00;30000;26496;3504;2.3
20073568;288259;7;15.11.2024 00:00;47046;25056;21990;2.2
20073565;285842;7;16.11.2024 00:00;40810;31680;9130;2.6
20042504;277214;8;03.01.2023 00:00;89119;70980;18139;6.4
20042730;268026;8;03.01.2023 00:00;59202;56552;2650;4.8
20042502;273035;8;03.01.2023 00:00;51000;25410;25590;3.5
20042833;;8;04.01.2023 00:00;0;0;0;0.0
20042087;282031;8;04.01.2023 00:00;15520;10140;5380;0.9
20042088;282196;8;04.01.2023 00:00;15502;10533;4969;0.9
20042089;282197;8;04.01.2023 00:00;12730;10920;1810;0.9
20042085;281726;8;04.01.2023 00:00;54050;49530;4520;4.6
20042078;263660;8;05.01.2023 00:00;28670;20280;8390;2.2
20042084;281652;8;05.01.2023 00:00;13000;12090;910;1.7
20042082;279879;8;05.01.2023 00:00;11818;11311;507;1.3
20042079;279703;8;05.01.2023 00:00;14030;10920;3110;1.0
20042083;280716;8;05.01.2023 00:00;21850;20280;1570;2.0
20042080;279769;8;05.01.2023 00:00;11780;10920;860;1.0
20042081;279877;8;05.01.2023 00:00;104304;87362;16942;8.4
20042086;281926;8;06.01.2023 00:00;67258;56160;11098;6.1
20042076;254250;8;06.01.2023 00:00;24050;20280;3770;2.0
20042731;274934;8;06.01.2023 00:00;83742;64350;19392;5.7
20042734;280942;8;07.01.2023 00:00;118334;107250;11084;9.1
20042735;280942;8;08.01.2023 00:00;119606;107250;12356;9.2
20042733;280918;8;08.01.2023 00:00;120090;107250;12840;9.7
20042732;280895;8;08.01.2023 00:00;90170;85800;4370;7.7
20043352;280919;8;09.01.2023 00:00;595250;514800;80450;52.0
20043566;276300;8;15.01.2023 00:00;85320;85800;-480;8.0
20042490;;8;15.01.2023 00:00;0;0;0;0.0
20042908;210305;8;15.01.2023 00:00;130668;101376;29292;10.0
20041923;281796;8;16.01.2023 00:00;2502;2502;0;3.4
20042910;282039;8;16.01.2023 00:00;3900;529;3371;0.2
20042909;271013;8;16.01.2023 00:00;54600;52272;2328;4.1
20043038;268027;8;17.01.2023 00:00;58000;52272;5728;4.0
20042766;;8;18.01.2023 00:00;0;0;0;0.0
20043045;274276;8;18.01.2023 00:00;108796;95040;13756;7.6
20043039;271740;8;18.01.2023 00:00;35199;15312;19887;1.4
20043041;278255;8;18.01.2023 00:00;140547;120914;19633;10.2
20043040;277927;8;18.01.2023 00:00;18000;15841;2159;1.2
20043043;279074;8;19.01.2023 00:00;23850;17424;6426;1.3
20043042;278255;8;19.01.2023 00:00;11809;10560;1249;1.0
20043044;280405;8;19.01.2023 00:00;76361;70224;6137;5.5
20043097;271552;8;20.01.2023 00:00;46844;33000;13844;3.2
20043100;278238;8;20.01.2023 00:00;56350;50688;5662;4.8
20043101;278238;8;20.01.2023 00:00;72132;69698;2434;6.0
20043098;278237;8;20.01.2023 00:00;99180;76032;23148;7.2
20043099;278237;8;21.01.2023 00:00;12330;10560;1770;0.9
20043103;279082;8;21.01.2023 00:00;12690;10824;1866;1.2
20043096;266886;8;21.01.2023 00:00;13340;10560;2780;0.9
20043105;282200;8;21.01.2023 00:00;15002;16898;-1896;2.1
20043102;279080;8;21.01.2023 00:00;30025;24552;5473;2.2
20042808;;8;22.01.2023 00:00;0;0;0;0.0
20043104;281655;8;22.01.2023 00:00;15200;10296;4904;1.3
20043548;221764;8;22.01.2023 00:00;51460;33542;17918;3.9
20043550;274511;8;22.01.2023 00:00;37200;28080;9120;2.2
20041644;282186;8;23.01.2023 00:00;2;2;0;9.8
20043764;;8;23.01.2023 00:00;0;0;0;0.0
20043646;277544;8;23.01.2023 00:00;137022;100132;36890;8.2
20043368;280918;8;24.01.2023 00:00;110280;85800;24480;7.2
20043369;280918;8;24.01.2023 00:00;284140;257400;26740;19.2
20043617;280895;8;25.01.2023 00:00;70362;77612;-7250;5.0
20043618;280895;8;26.01.2023 00:00;397024;364652;32372;27.4
20043644;275442;8;27.01.2023 00:00;173933;150152;23781;11.3
20043645;276721;8;28.01.2023 00:00;69622;64352;5270;4.9
20043741;280920;8;28.01.2023 00:00;294099;278852;15247;20.3
20043891;279506;8;29.01.2023 00:00;425426;386100;39326;28.6
20043993;278314;8;30.01.2023 00:00;185972;171602;14370;13.1
20044419;282953;8;31.01.2023 00:00;112920;107250;5670;7.8
20044093;276810;8;31.01.2023 00:00;125502;107252;18250;8.7
20044094;280919;8;01.02.2023 00:00;238911;214500;24411;15.6
20044095;280943;8;02.02.2023 00:00;133357;128700;4657;9.6
20044151;;8;02.02.2023 00:00;0;0;0;0.0
20044527;278153;8;02.02.2023 00:00;19000;9750;9250;1.0
20044529;276468;8;02.02.2023 00:00;136870;98280;38590;9.8
20044531;276468;8;03.02.2023 00:00;32832;28082;4750;2.9
20044660;276468;8;03.02.2023 00:00;48966;35880;13086;3.4
20044533;274511;8;04.02.2023 00:00;127252;102962;24290;10.1
20044532;276474;8;04.02.2023 00:00;46934;34320;12614;3.7
20044534;276670;8;04.02.2023 00:00;81700;68640;13060;6.4
20044537;283027;8;05.02.2023 00:00;244400;215280;29120;20.5
20044536;279155;8;05.02.2023 00:00;24300;21840;2460;2.1
20041642;282191;8;06.02.2023 00:00;10141;10141;0;5.1
20044539;282186;8;06.02.2023 00:00;10140;10140;0;3.6
20044535;274510;8;06.02.2023 00:00;65004;53044;11960;5.1
20044778;274510;8;07.02.2023 00:00;493040;443043;49997;39.7
20044145;283042;8;09.02.2023 00:00;601800;493350;108450;39.5
20044420;;8;09.02.2023 00:00;0;0;0;0.0
20044484;283042;8;11.02.2023 00:00;527604;493350;34254;36.7
20044665;282714;8;13.02.2023 00:00;126786;102960;23826;8.9
20044930;282398;8;14.02.2023 00:00;27373;17550;9823;1.9
20044773;282663;8;14.02.2023 00:00;24880;19500;5380;1.9
20044777;271298;8;14.02.2023 00:00;26317;21842;4475;1.9
20044764;279702;8;14.02.2023 00:00;23002;20282;2720;1.9
20044767;279879;8;14.02.2023 00:00;23002;20282;2720;1.9
20044771;282196;8;14.02.2023 00:00;15748;10921;4827;1.1
20044768;280219;8;14.02.2023 00:00;37306;30420;6886;2.6
20044763;276848;8;14.02.2023 00:00;11261;10922;339;1.1
20044770;281565;8;15.02.2023 00:00;11827;10920;907;1.2
20044765;279703;8;15.02.2023 00:00;25272;24960;312;2.4
20044772;282401;8;15.02.2023 00:00;29817;26133;3684;2.4
20044766;279877;8;15.02.2023 00:00;43542;32762;10780;2.8
20045516;281324;8;15.02.2023 00:00;584322;493350;90972;37.8
20044769;281420;8;15.02.2023 00:00;22502;22232;270;2.0
20045354;283352;8;18.02.2023 00:00;128800;104133;24667;7.6
20044746;;8;18.02.2023 00:00;0;0;0;0.0
20044982;276670;8;18.02.2023 00:00;91239;68640;22599;5.2
20044981;276474;8;19.02.2023 00:00;146263;135722;10541;9.8
20044983;279155;8;19.02.2023 00:00;37002;34322;2680;2.5
20045077;274511;8;19.02.2023 00:00;160960;134160;26800;10.9
20045744;283027;8;20.02.2023 00:00;125538;90481;35057;6.7
20045743;277214;8;21.02.2023 00:00;71606;56163;15443;5.2
20045742;275923;8;21.02.2023 00:00;186038;143520;42518;13.4
20045152;;8;22.02.2023 00:00;0;0;0;0.0
20045172;279506;8;22.02.2023 00:00;473018;429000;44018;31.8
20045442;281324;8;24.02.2023 00:00;1023413;943800;79613;69.5
20044623;;8;28.02.2023 00:00;0;0;0;0.0
20045681;272642;8;28.02.2023 00:00;47360;21125;26235;1.8
20045682;274276;8;28.02.2023 00:00;53842;48048;5794;4.5
20045680;278238;8;01.03.2023 00:00;103594;90818;12776;7.8
20045730;271740;8;01.03.2023 00:00;56884;49632;7252;3.8
20045731;278255;8;01.03.2023 00:00;84923;66000;18923;5.6
20045775;278254;8;02.03.2023 00:00;32980;21912;11068;1.7
20045773;278237;8;02.03.2023 00:00;29420;25344;4076;2.1
20045774;278237;8;03.03.2023 00:00;34600;30624;3976;2.7
20045776;279083;8;03.03.2023 00:00;9961;10560;-599;1.0
20045308;;8;03.03.2023 00:00;0;0;0;0.0
20046086;253777;8;03.03.2023 00:00;46640;10032;36608;1.1
20045771;268067;8;03.03.2023 00:00;56826;30097;26729;2.9
20045772;268068;8;03.03.2023 00:00;11676;10034;1642;1.2
20045770;268066;8;04.03.2023 00:00;175288;120122;55166;13.0
20045815;210305;8;05.03.2023 00:00;60942;25346;35596;2.8
20045817;230381;8;05.03.2023 00:00;22091;15048;7043;1.6
20045816;227368;8;06.03.2023 00:00;32534;30624;1910;3.4
20046153;279403;8;06.03.2023 00:00;103375;85184;18191;7.3
20046155;282677;8;06.03.2023 00:00;68808;46224;22584;4.8
20045727;;8;07.03.2023 00:00;0;0;0;0.0
20046154;276670;8;07.03.2023 00:00;193184;159900;33284;11.8
20046156;;8;08.03.2023 00:00;0;0;0;0.0
20046010;279506;8;08.03.2023 00:00;630012;557702;72310;41.3
20046219;282591;8;10.03.2023 00:00;118071;107252;10819;8.3
20046269;280920;8;10.03.2023 00:00;63891;64350;-459;4.9
20045855;283165;8;11.03.2023 00:00;103200;85800;17400;6.4
20046081;283165;8;11.03.2023 00:00;65250;64350;900;4.5
20045854;282864;8;11.03.2023 00:00;273294;235952;37342;18.6
20046084;283167;8;16.03.2023 00:00;67550;64350;3200;4.8
20046271;283575;8;16.03.2023 00:00;423302;386102;37200;29.0
20046387;283575;8;17.03.2023 00:00;381262;343202;38060;25.8
20046642;280919;8;19.03.2023 00:00;123940;107250;16690;7.9
20046970;;8;19.03.2023 00:00;0;0;0;0.0
20046969;267874;8;19.03.2023 00:00;274029;210600;63429;19.8
20047181;283568;8;21.03.2023 00:00;334308;252722;81586;21.0
20047179;;8;22.03.2023 00:00;0;0;0;0.0
20047684;281324;8;22.03.2023 00:00;773310;686400;86910;49.6
20047124;280920;8;25.03.2023 00:00;178756;150152;28604;12.1
20046481;282864;8;28.03.2023 00:00;405532;343204;62328;27.3
20047180;283774;8;29.03.2023 00:00;2340;2340;0;1.6
20046894;;8;29.03.2023 00:00;0;0;0;0.0
20046899;274276;8;30.03.2023 00:00;72196;63360;8836;5.2
20046898;278255;8;30.03.2023 00:00;30684;10034;20650;1.4
20046901;283701;8;30.03.2023 00:00;58936;45144;13792;4.0
20047245;283628;8;31.03.2023 00:00;2642;530;2112;0.3
20046897;223245;8;31.03.2023 00:00;41289;20064;21225;2.6
20047678;;8;31.03.2023 00:00;0;0;0;0.0
20046895;;8;31.03.2023 00:00;0;0;0;0.0
20048029;283745;8;31.03.2023 00:00;251751;224642;27109;18.9
20048028;;8;01.04.2023 00:00;0;0;0;0.0
20047621;280919;8;01.04.2023 00:00;287554;235950;51604;18.9
20047620;280895;8;03.04.2023 00:00;219762;171604;48158;15.0
20047622;280943;8;05.04.2023 00:00;83004;64350;18654;6.1
20047624;283726;8;05.04.2023 00:00;222533;202802;19731;16.1
20048641;283165;8;06.04.2023 00:00;178577;150150;28427;12.5
20047883;283575;8;11.04.2023 00:00;571122;536252;34870;39.2
20048271;283575;8;13.04.2023 00:00;570280;536252;34028;39.5
20048494;283575;8;15.04.2023 00:00;640604;579154;61450;44.5
20048652;283166;8;17.04.2023 00:00;316202;298352;17850;22.3
20048715;280895;8;18.04.2023 00:00;126424;107254;19170;9.7
20048773;283719;8;19.04.2023 00:00;13;13;0;8.3
20048460;283332;8;19.04.2023 00:00;17000;10920;6080;1.1
20048459;283332;8;19.04.2023 00:00;14000;11310;2690;1.2
20048455;281658;8;19.04.2023 00:00;22000;20280;1720;2.2
20048454;281658;8;19.04.2023 00:00;25879;20280;5599;2.0
20048457;282398;8;20.04.2023 00:00;11199;10920;279;1.2
20048448;276848;8;20.04.2023 00:00;14151;10920;3231;1.0
20048449;276848;8;20.04.2023 00:00;12521;10920;1601;1.3
20048450;279880;8;20.04.2023 00:00;1200;10920;-9720;1.1
20048456;282398;8;20.04.2023 00:00;12000;10920;1080;1.1
20048451;279880;8;20.04.2023 00:00;12000;10920;1080;1.1
20048452;280212;8;20.04.2023 00:00;15000;10920;4080;1.2
20048453;280212;8;20.04.2023 00:00;12000;10920;1080;1.3
20048447;;8;20.04.2023 00:00;0;0;0;0.0
20048462;277183;8;20.04.2023 00:00;45900;34320;11580;3.3
20048725;274511;8;21.04.2023 00:00;40128;35882;4246;3.7
20048716;283727;8;21.04.2023 00:00;1;1;0;7.5
20048699;;8;21.04.2023 00:00;0;0;0;0.0
20048728;283741;8;21.04.2023 00:00;31429;15841;15588;1.5
20048721;;8;21.04.2023 00:00;0;0;0;0.0
20048726;279075;8;22.04.2023 00:00;56598;47786;8812;4.7
20048722;271919;8;22.04.2023 00:00;14700;10561;4139;0.8
20048724;272642;8;22.04.2023 00:00;12902;10562;2340;1.0
20048723;272452;8;22.04.2023 00:00;20100;10560;9540;1.1
20048700;;8;23.04.2023 00:00;0;0;0;0.0
20048727;279080;8;23.04.2023 00:00;11689;10560;1129;1.2
20048751;283166;8;23.04.2023 00:00;86711;66302;20409;5.0
20048752;283173;8;23.04.2023 00:00;124540;107250;17290;8.6
20048863;283167;8;24.04.2023 00:00;77335;64352;12983;5.4
20048864;283575;8;24.04.2023 00:00;358517;321750;36767;25.4
20048964;280920;8;25.04.2023 00:00;76780;64350;12430;4.7
20048999;276810;8;26.04.2023 00:00;74320;64350;9970;4.9
20049000;280918;8;26.04.2023 00:00;121997;107252;14745;9.0
20049003;283726;8;26.04.2023 00:00;263735;234000;29735;21.5
20049043;283895;8;28.04.2023 00:00;128540;109200;19340;8.2
20049042;283894;8;28.04.2023 00:00;123820;109200;14620;8.9
20049076;279506;8;29.04.2023 00:00;168239;150152;18087;11.3
20049077;283920;8;29.04.2023 00:00;184508;171603;12905;12.6
20049078;283922;8;30.04.2023 00:00;77000;64350;12650;5.2
20049359;283924;8;30.04.2023 00:00;108550;107250;1300;7.7
20049358;283924;8;30.04.2023 00:00;69000;64350;4650;4.9
20049354;282864;8;01.05.2023 00:00;117432;107250;10182;8.1
20049357;283167;8;01.05.2023 00:00;43930;85800;-41870;7.0
20049433;283173;8;02.05.2023 00:00;70860;64350;6510;5.0
20049435;283938;8;02.05.2023 00:00;350100;321750;28350;24.5
20049572;283938;8;03.05.2023 00:00;49579;42902;6677;4.6
20049436;283979;8;04.05.2023 00:00;87043;85800;1243;5.7
20049456;280919;8;04.05.2023 00:00;322420;300300;22120;22.4
20049585;280919;8;05.05.2023 00:00;237900;214500;23400;16.3
20049495;280895;8;06.05.2023 00:00;67127;64351;2776;4.6
20049497;280941;8;06.05.2023 00:00;70090;64350;5740;4.7
20049496;280918;8;06.05.2023 00:00;140010;128700;11310;9.7
20049566;280918;8;07.05.2023 00:00;69402;64352;5050;5.0
20049567;280943;8;07.05.2023 00:00;70380;64350;6030;4.7
20049587;283575;8;07.05.2023 00:00;398870;364650;34220;28.2
20049680;283575;8;09.05.2023 00:00;255505;235950;19555;17.8
20049679;282864;8;10.05.2023 00:00;180785;171600;9185;12.8
20050019;282864;8;10.05.2023 00:00;192510;171600;20910;12.4
20050244;282864;8;11.05.2023 00:00;114252;107252;7000;8.4
20049722;283165;8;11.05.2023 00:00;369482;343202;26280;25.3
20050020;283165;8;12.05.2023 00:00;114520;107250;7270;8.1
20050021;283173;8;13.05.2023 00:00;114150;107252;6898;8.4
20050248;283167;8;13.05.2023 00:00;110984;107252;3732;8.2
20050018;283042;8;14.05.2023 00:00;397937;364650;33287;27.3
20049774;;8;15.05.2023 00:00;0;0;0;0.0
20049922;236359;8;15.05.2023 00:00;56520;31682;24838;3.9
20049921;201695;8;16.05.2023 00:00;42367;30626;11741;2.9
20049924;268066;8;16.05.2023 00:00;151500;120120;31380;13.9
20049925;268067;8;17.05.2023 00:00;33038;30096;2942;2.9
20049923;253777;8;17.05.2023 00:00;9295;10034;-739;1.2
20049926;268068;8;17.05.2023 00:00;17662;10032;7630;1.1
20050014;239490;8;18.05.2023 00:00;87947;66000;21947;5.7
20049929;279083;8;18.05.2023 00:00;34000;13728;20272;1.6
20050116;;8;18.05.2023 00:00;0;0;0;0.0
20050063;282217;8;18.05.2023 00:00;162263;145731;16532;13.5
20049928;275220;8;19.05.2023 00:00;56527;49632;6895;4.6
20049920;;8;19.05.2023 00:00;0;0;0;0.0
20050243;280895;8;20.05.2023 00:00;379803;321750;58053;25.3
20050294;283575;8;21.05.2023 00:00;569956;514800;55156;39.5
20050246;283165;8;23.05.2023 00:00;322389;300300;22089;22.5
20050910;284344;8;24.05.2023 00:00;390;390;0;2.0
20050393;274759;8;25.05.2023 00:00;120420;102180;18240;10.8
20050392;274759;8;25.05.2023 00:00;127126;115052;12074;10.8
20050394;282714;8;26.05.2023 00:00;62426;50310;12116;6.1
20050097;276846;8;26.05.2023 00:00;12000;10920;1080;1.3
20050102;282720;8;26.05.2023 00:00;17000;10920;6080;1.0
20050191;281831;8;27.05.2023 00:00;38046;34321;3725;3.5
20050103;283335;8;27.05.2023 00:00;11560;10920;640;1.2
20050190;279879;8;27.05.2023 00:00;25300;21840;3460;2.1
20050100;282663;8;27.05.2023 00:00;15060;10920;4140;1.0
20050099;282401;8;27.05.2023 00:00;40130;35880;4250;3.8
20050104;283838;8;27.05.2023 00:00;22500;21840;660;2.1
20050101;282664;8;27.05.2023 00:00;11500;10920;580;1.1
20050105;284070;8;28.05.2023 00:00;40120;26520;13600;2.7
20050703;283575;8;28.05.2023 00:00;813595;729300;84295;55.9
20050098;281420;8;28.05.2023 00:00;28255;26520;1735;3.1
20050772;280920;8;31.05.2023 00:00;763950;707850;56100;52.5
20050893;280920;8;03.06.2023 00:00;775830;707850;67980;54.1
20051057;280920;8;05.06.2023 00:00;555720;514800;40920;38.1
20051059;280920;8;07.06.2023 00:00;203602;193052;10550;14.5
20051058;280920;8;08.06.2023 00:00;114500;107250;7250;8.2
20050952;283895;8;08.06.2023 00:00;120000;109200;10800;8.5
20051044;283575;8;09.06.2023 00:00;69302;64352;4950;5.0
20051231;283575;8;09.06.2023 00:00;228317;214502;13815;16.2
20051411;;8;10.06.2023 00:00;0;0;0;0.0
20051412;283745;8;10.06.2023 00:00;81257;50312;30945;4.4
20051228;271620;8;10.06.2023 00:00;20940;10920;10020;1.3
20051225;221764;8;11.06.2023 00:00;65239;40560;24679;5.7
20051218;;8;11.06.2023 00:00;0;0;0;0.0
20051226;268066;8;11.06.2023 00:00;156370;126720;29650;12.3
20051227;268068;8;12.06.2023 00:00;34794;27457;7337;2.7
20051720;283847;8;12.06.2023 00:00;183616;146896;36720;12.4
20051232;284281;8;13.06.2023 00:00;23839;10824;13015;1.1
20051224;;8;13.06.2023 00:00;0;0;0;0.0
20051230;280406;8;14.06.2023 00:00;50217;34849;15368;3.3
20051700;;8;14.06.2023 00:00;0;0;0;0.0
20051229;279083;8;14.06.2023 00:00;14748;10560;4188;1.1
20051713;272663;8;14.06.2023 00:00;65620;54600;11020;5.1
20051721;284408;8;15.06.2023 00:00;39645;40054;-409;4.4
20051715;280919;8;15.06.2023 00:00;126749;107250;19499;8.7
20051931;280919;8;16.06.2023 00:00;270470;235950;34520;18.8
20051714;280918;8;17.06.2023 00:00;113060;107250;5810;8.7
20051930;280918;8;17.06.2023 00:00;108642;107279;1363;7.8
20051929;280895;8;18.06.2023 00:00;139700;128700;11000;9.9
20051716;281324;8;18.06.2023 00:00;368713;343204;25509;26.5
20051717;281324;8;20.06.2023 00:00;358250;343202;15048;26.0
20051718;282864;8;21.06.2023 00:00;119963;107250;12713;8.5
20051932;282864;8;21.06.2023 00:00;261690;235950;25740;18.4
20051719;283166;8;24.06.2023 00:00;114219;107252;6967;8.4
20051933;283924;8;24.06.2023 00:00;255430;235952;19478;18.5
20051754;;8;25.06.2023 00:00;0;0;0;0.0
20052229;284062;8;25.06.2023 00:00;59439;18720;40719;2.2
20051756;283350;8;26.06.2023 00:00;69027;54992;14035;5.0
20051755;274510;8;26.06.2023 00:00;90991;69810;21181;7.1
20051757;284392;8;27.06.2023 00:00;131324;102960;28364;10.4
20052304;;8;27.06.2023 00:00;0;0;0;0.0
20052312;280919;8;27.06.2023 00:00;375316;321750;53566;27.1
20052314;280943;8;29.06.2023 00:00;125255;107252;18003;8.0
20052310;276810;8;29.06.2023 00:00;116523;107250;9273;9.3
20052313;280941;8;30.06.2023 00:00;126710;107250;19460;8.7
20052311;280918;8;30.06.2023 00:00;163982;146252;17730;11.2
20052616;280895;8;01.07.2023 00:00;133191;107252;25939;9.8
20052316;282953;8;02.07.2023 00:00;195748;171602;24146;13.4
20052315;282864;8;02.07.2023 00:00;124972;107252;17720;8.5
20052617;282864;8;03.07.2023 00:00;267346;235950;31396;17.7
20052619;283575;8;04.07.2023 00:00;117470;107252;10218;8.4
20052618;283166;8;05.07.2023 00:00;300320;278852;21468;21.4
20052872;283979;8;07.07.2023 00:00;66352;64352;2000;4.6
20052871;281324;8;07.07.2023 00:00;399089;364652;34437;27.5
20053005;281926;8;09.07.2023 00:00;161633;140400;21233;13.5
20053008;282401;8;09.07.2023 00:00;27410;26520;890;2.5
20053003;281652;8;10.07.2023 00:00;17190;10920;6270;1.2
20053006;282196;8;10.07.2023 00:00;11570;10140;1430;0.9
20053007;282197;8;10.07.2023 00:00;12710;10920;1790;1.2
20052998;277234;8;10.07.2023 00:00;23014;21840;1174;2.0
20053010;284072;8;10.07.2023 00:00;12693;10922;1771;1.1
20053000;279703;8;10.07.2023 00:00;36827;32762;4065;3.3
20053001;279879;8;10.07.2023 00:00;41634;37441;4193;3.6
20052999;279702;8;10.07.2023 00:00;47900;45240;2660;4.1
20053009;282663;8;12.07.2023 00:00;41726;37440;4286;3.6
20053002;281420;8;12.07.2023 00:00;32945;26910;6035;2.4
20053004;281831;8;12.07.2023 00:00;50208;47192;3016;4.5
20052997;263788;8;12.07.2023 00:00;44500;29740;14760;2.8
20051969;;8;13.07.2023 00:00;0;0;0;0.0
20052996;255612;8;13.07.2023 00:00;43000;35880;7120;3.9
20052317;277066;8;13.07.2023 00:00;57930;44880;13050;4.0
20052735;201691;8;14.07.2023 00:00;51519;15841;35678;2.3
20052736;277052;8;14.07.2023 00:00;83340;61514;21826;7.3
20053545;283167;8;31.07.2023 00:00;133546;107252;26294;8.2
20053543;283165;8;01.08.2023 00:00;125640;107250;18390;8.8
20053895;282864;8;01.08.2023 00:00;137378;128700;8678;9.5
20053544;283166;8;02.08.2023 00:00;125796;107250;18546;8.7
20053542;280919;8;02.08.2023 00:00;144925;128700;16225;9.8
20053892;280919;8;03.08.2023 00:00;209725;193050;16675;14.3
20053891;280918;8;04.08.2023 00:00;332060;300300;31760;23.5
20053893;280941;8;05.08.2023 00:00;188728;171603;17125;13.1
20053890;280895;8;05.08.2023 00:00;119545;107250;12295;7.7
20054101;281324;8;06.08.2023 00:00;158090;150150;7940;11.4
20053894;281324;8;06.08.2023 00:00;180800;171600;9200;12.7
20053994;281324;8;07.08.2023 00:00;122860;107250;15610;8.3
20054230;281324;8;07.08.2023 00:00;385462;347882;37580;24.9
20053896;279506;8;09.08.2023 00:00;557900;514800;43100;38.1
20054278;280942;8;11.08.2023 00:00;126307;107250;19057;8.8
20054298;283745;8;12.08.2023 00:00;36825;14040;22785;2.2
20054296;;8;12.08.2023 00:00;0;0;0;0.0
20054297;;8;16.08.2023 00:00;0;0;0;0.0
20054301;284375;8;16.08.2023 00:00;49462;36696;12766;4.2
20054302;284376;8;16.08.2023 00:00;35365;20330;15035;2.5
20054304;284796;8;17.08.2023 00:00;59493;53330;6163;5.4
20054303;284579;8;17.08.2023 00:00;73186;50690;22496;5.5
20054300;283701;8;18.08.2023 00:00;68807;62042;6765;5.7
20054310;;8;18.08.2023 00:00;0;0;0;0.0
20054305;284832;8;18.08.2023 00:00;33233;33266;-33;3.4
20054471;283166;8;19.08.2023 00:00;138134;107252;30882;8.9
20054279;282864;8;19.08.2023 00:00;400082;343200;56882;26.2
20054484;282864;8;21.08.2023 00:00;398050;364650;33400;27.5
20054896;282864;8;22.08.2023 00:00;114567;107250;7317;8.4
20054566;285050;8;23.08.2023 00:00;335695;300302;35393;23.2
20054897;285050;8;24.08.2023 00:00;121400;107250;14150;8.2
20055124;283042;8;24.08.2023 00:00;374204;321754;52450;23.6
20054483;281324;8;26.08.2023 00:00;272812;257402;15410;18.9
20054481;276810;8;27.08.2023 00:00;302680;278850;23830;23.8
20054895;280941;8;28.08.2023 00:00;327600;300300;27300;25.9
20055139;280941;8;30.08.2023 00:00;124417;107250;17167;9.1
20055136;280895;8;31.08.2023 00:00;138602;129482;9120;9.7
20055311;280918;8;31.08.2023 00:00;79800;64350;15450;4.9
20055493;280942;8;01.09.2023 00:00;118386;107252;11134;8.2
20055140;281324;8;01.09.2023 00:00;116696;107250;9446;8.6
20055125;285095;8;02.09.2023 00:00;140165;128700;11465;10.0
20055450;285149;8;02.09.2023 00:00;131255;128700;2555;9.5
20055451;285150;8;03.09.2023 00:00;139750;128700;11050;9.6
20054485;282953;8;03.09.2023 00:00;111450;107250;4200;8.1
20054893;279506;8;04.09.2023 00:00;417002;386102;30900;28.1
20054894;279506;8;05.09.2023 00:00;410970;386100;24870;28.6
20055143;283924;8;06.09.2023 00:00;228530;214500;14030;16.2
20055141;283165;8;07.09.2023 00:00;116700;107250;9450;8.1
20055496;283167;8;07.09.2023 00:00;113803;107255;6548;7.8
20055538;;8;08.09.2023 00:00;0;0;0;0.0
20055539;285141;8;08.09.2023 00:00;157195;127141;30054;11.3
20055363;201695;8;09.09.2023 00:00;59880;32472;27408;3.7
20055343;;8;09.09.2023 00:00;0;0;0;0.0
20055364;210305;8;09.09.2023 00:00;123095;100320;22775;10.6
20055345;253777;8;10.09.2023 00:00;17172;13733;3439;2.1
20055348;268068;8;10.09.2023 00:00;30986;27456;3530;2.8
20055347;268067;8;11.09.2023 00:00;17474;10560;6914;1.6
20055346;268066;8;11.09.2023 00:00;149906;126722;23184;11.7
20055349;283701;8;12.09.2023 00:00;111046;101376;9670;8.8
20055362;;8;12.09.2023 00:00;0;0;0;0.0
20055350;284375;8;12.09.2023 00:00;56600;46464;10136;4.0
20055365;284376;8;13.09.2023 00:00;136450;129889;6561;10.2
20055351;284796;8;13.09.2023 00:00;34350;30624;3726;2.7
20055540;285028;8;13.09.2023 00:00;80660;67584;13076;6.2
20055541;285084;8;13.09.2023 00:00;18700;15840;2860;1.4
20055344;;8;14.09.2023 00:00;0;0;0;0.0
20055883;285201;8;14.09.2023 00:00;108835;90480;18355;6.8
20055897;;8;15.09.2023 00:00;0;0;0;0.0
20055767;283938;8;15.09.2023 00:00;427301;386102;41199;29.3
20055768;282864;8;16.09.2023 00:00;382420;364650;17770;26.9
20055956;285095;8;18.09.2023 00:00;196248;171600;24648;13.0
20056124;285095;8;19.09.2023 00:00;145240;128700;16540;9.4
20055958;285150;8;19.09.2023 00:00;130048;131432;-1384;9.3
20055957;285149;8;20.09.2023 00:00;117470;107250;10220;7.6
20055955;281324;8;20.09.2023 00:00;583190;557700;25490;40.7
20056123;280920;8;22.09.2023 00:00;491009;471900;19109;34.6
20055494;283042;8;23.09.2023 00:00;484832;450452;34380;32.5
20055495;283042;8;25.09.2023 00:00;473775;450450;23325;32.8
20056270;283726;8;27.09.2023 00:00;111052;113882;-2830;8.0
20056379;285095;8;27.09.2023 00:00;297858;278850;19008;20.7
20056386;280919;8;28.09.2023 00:00;180394;171600;8794;13.1
20056372;;8;29.09.2023 00:00;0;0;0;0.0
20056378;283350;8;29.09.2023 00:00;134373;99843;34530;8.2
20056373;;8;29.09.2023 00:00;0;0;0;0.0
20056681;283165;8;30.09.2023 00:00;136820;128700;8120;10.1
20056308;282864;8;30.09.2023 00:00;177480;171600;5880;12.4
20056685;282864;8;01.10.2023 00:00;322168;300300;21868;22.1
20056686;282953;8;02.10.2023 00:00;111389;117782;-6393;8.2
20056689;285150;8;02.10.2023 00:00;188903;171600;17303;13.0
20056684;281324;8;03.10.2023 00:00;344333;321750;22583;24.5
20056688;285149;8;04.10.2023 00:00;116700;107250;9450;8.1
20056687;285095;8;04.10.2023 00:00;467430;450450;16980;32.5
20056682;276810;8;06.10.2023 00:00;291780;278850;12930;20.0
20056683;279506;8;07.10.2023 00:00;493015;471900;21115;34.9
20056870;;8;08.10.2023 00:00;0;0;0;0.0
20056872;268067;8;09.10.2023 00:00;42870;31680;11190;3.9
20056873;279358;8;09.10.2023 00:00;39283;29832;9451;3.5
20056967;;8;09.10.2023 00:00;0;0;0;0.0
20056874;285026;8;10.10.2023 00:00;83365;58080;25285;5.5
20056871;;8;10.10.2023 00:00;0;0;0;0.0
20057120;285141;8;10.10.2023 00:00;70426;44850;25576;4.4
20057023;278853;8;10.10.2023 00:00;37196;26520;10676;3.5
20057028;;8;12.10.2023 00:00;0;0;0;0.0
20057030;282864;8;12.10.2023 00:00;643585;579150;64435;43.9
20057032;283165;8;14.10.2023 00:00;120300;107250;13050;8.1
20057033;283167;8;14.10.2023 00:00;112300;107250;5050;8.1
20057035;283979;8;15.10.2023 00:00;201232;183692;17540;14.1
20057031;282953;8;15.10.2023 00:00;119883;107253;12630;8.2
20057284;282953;8;16.10.2023 00:00;110315;107252;3063;7.9
20057034;283924;8;16.10.2023 00:00;235450;214502;20948;15.9
20057285;283924;8;17.10.2023 00:00;125166;107250;17916;8.3
20057161;280942;8;18.10.2023 00:00;110755;107250;3505;7.8
20057283;280895;8;18.10.2023 00:00;120290;107250;13040;8.1
20057029;279506;8;19.10.2023 00:00;488600;450450;38150;34.3
20057117;279506;8;21.10.2023 00:00;468392;450452;17940;32.8
20057563;285663;8;22.10.2023 00:00;193412;171602;21810;13.0
20057160;285095;8;23.10.2023 00:00;112651;107250;5401;8.1
20057159;280920;8;23.10.2023 00:00;186500;171600;14900;12.8
20057287;285150;8;24.10.2023 00:00;115450;107250;8200;8.1
20057286;285095;8;24.10.2023 00:00;407397;386102;21295;29.4
20057355;283167;8;26.10.2023 00:00;205111;193051;12060;14.2
20057406;283165;8;27.10.2023 00:00;110974;107250;3724;8.4
20057405;282864;8;27.10.2023 00:00;314350;300300;14050;22.2
20057900;282864;8;28.10.2023 00:00;447850;429000;18850;30.4
20057901;282864;8;29.10.2023 00:00;444410;429000;15410;32.0
20057902;282864;8;31.10.2023 00:00;442810;429000;13810;31.2
20058093;283167;8;01.11.2023 00:00;448820;429000;19820;30.9
20058195;283165;8;03.11.2023 00:00;378180;364650;13530;26.9
20057747;285147;8;04.11.2023 00:00;76436;66905;9531;5.6
20057367;277544;8;04.11.2023 00:00;112600;100776;11824;8.6
20057754;277544;8;05.11.2023 00:00;344590;321708;22882;25.2
20057753;277544;8;06.11.2023 00:00;105720;100776;4944;8.2
20057371;283345;8;06.11.2023 00:00;34510;25841;8669;2.3
20057888;283345;8;07.11.2023 00:00;24902;16475;8427;1.5
20057745;277469;8;07.11.2023 00:00;329755;301036;28719;28.7
20057748;285612;8;08.11.2023 00:00;30802;25843;4959;2.5
20058440;283345;8;08.11.2023 00:00;37350;33592;3758;3.3
20057892;285612;8;09.11.2023 00:00;63400;58140;5260;5.5
20057893;285614;8;09.11.2023 00:00;26490;25840;650;2.5
20057887;283084;8;09.11.2023 00:00;180491;162792;17699;15.3
20057749;285614;8;09.11.2023 00:00;26540;25840;700;2.4
20057890;284408;8;10.11.2023 00:00;114530;105944;8586;10.1
20057889;284408;8;10.11.2023 00:00;33581;25842;7739;2.6
20057746;284548;8;10.11.2023 00:00;109260;100776;8484;9.6
20057896;284548;8;11.11.2023 00:00;193070;178296;14774;16.3
20057897;285040;8;12.11.2023 00:00;29400;25841;3559;2.4
20057898;285040;8;12.11.2023 00:00;48300;43928;4372;4.0
20057899;285664;8;12.11.2023 00:00;4199;4199;0;2.6
20057407;;8;12.11.2023 00:00;0;0;0;0.0
20057776;256213;8;12.11.2023 00:00;75820;35100;40720;6.1
20058324;285439;8;13.11.2023 00:00;49309;28083;21226;4.5
20057777;277214;8;13.11.2023 00:00;71403;56161;15242;5.1
20058234;285766;8;14.11.2023 00:00;11900;15600;-3700;2.3
20057794;285253;8;14.11.2023 00:00;32742;15578;17164;1.7
20057416;;8;14.11.2023 00:00;0;0;0;0.0
20057793;284376;8;14.11.2023 00:00;59500;50688;8812;4.7
20057792;284375;8;14.11.2023 00:00;28720;25080;3640;2.2
20057796;285681;8;15.11.2023 00:00;32100;31416;684;3.0
20057795;285542;8;15.11.2023 00:00;40878;33792;7086;3.1
20057791;283701;8;15.11.2023 00:00;57200;49104;8096;4.8
20058441;;8;15.11.2023 00:00;0;0;0;0.0
20058442;285791;8;15.11.2023 00:00;12738;11352;1386;1.3
20057833;268066;8;16.11.2023 00:00;160182;126720;33462;11.8
20057832;268067;8;17.11.2023 00:00;20800;21120;-320;1.9
20057831;253777;8;17.11.2023 00:00;21000;13728;7272;1.6
20057690;285623;8;17.11.2023 00:00;25608;25608;0;8.7
20057415;285620;8;17.11.2023 00:00;46194;46194;0;13.0
20057417;;8;18.11.2023 00:00;0;0;0;0.0
20058354;276810;8;18.11.2023 00:00;322216;278850;43366;21.4
20058319;285800;8;19.11.2023 00:00;190144;171600;18544;12.9
20058478;285800;8;20.11.2023 00:00;137490;128700;8790;9.5
20058475;285150;8;21.11.2023 00:00;230100;214500;15600;16.5
20058476;285150;8;21.11.2023 00:00;395330;386100;9230;28.0
20058474;285095;8;23.11.2023 00:00;140646;128702;11944;9.5
20058318;283924;8;23.11.2023 00:00;131970;128700;3270;9.6
20058417;283726;8;24.11.2023 00:00;121000;109200;11800;8.3
20058447;283894;8;24.11.2023 00:00;110687;109200;1487;8.5
20058600;283895;8;25.11.2023 00:00;117950;109200;8750;8.0
20058355;282953;8;25.11.2023 00:00;123250;107250;16000;8.3
20058416;282953;8;25.11.2023 00:00;112420;107250;5170;8.0
20058757;285922;8;26.11.2023 00:00;541150;514800;26350;38.1
20058758;285922;8;27.11.2023 00:00;112300;107250;5050;7.9
20059093;285922;8;28.11.2023 00:00;105690;107250;-1560;7.7
20058599;283173;8;28.11.2023 00:00;113710;107250;6460;8.0
20058819;283173;8;29.11.2023 00:00;206646;193050;13596;14.1
20058821;285050;8;29.11.2023 00:00;220954;214500;6454;16.0
20058822;285050;8;30.11.2023 00:00;113200;107250;5950;7.8
20059091;286053;8;30.11.2023 00:00;137500;128700;8800;9.6
20059089;285150;8;01.12.2023 00:00;116570;107250;9320;8.1
20059092;285937;8;01.12.2023 00:00;114260;107250;7010;8.1
20058930;285921;8;02.12.2023 00:00;131571;128700;2871;9.7
20059094;285921;8;02.12.2023 00:00;115000;107250;7750;7.8
20058929;285930;8;03.12.2023 00:00;608150;579150;29000;42.1
20059090;285934;8;05.12.2023 00:00;110940;107250;3690;7.9
20059217;285935;8;05.12.2023 00:00;108850;107250;1600;7.7
20059234;280920;8;05.12.2023 00:00;494410;471900;22510;34.3
20059355;283042;8;07.12.2023 00:00;145330;128700;16630;10.2
20059235;286045;8;08.12.2023 00:00;4980;647;4333;0.3
20059233;277469;8;09.12.2023 00:00;326562;301038;25524;29.1
20059437;281926;8;10.12.2023 00:00;131142;104520;26622;10.8
20059433;279703;8;11.12.2023 00:00;31280;18721;12559;1.9
20059439;284071;8;11.12.2023 00:00;10740;10920;-180;1.1
20059434;279769;8;11.12.2023 00:00;13460;10920;2540;1.2
20059438;282663;8;11.12.2023 00:00;24722;20673;4049;2.3
20059436;281831;8;12.12.2023 00:00;26088;22230;3858;2.2
20059435;279879;8;12.12.2023 00:00;20560;19500;1060;1.9
20059358;;8;12.12.2023 00:00;0;0;0;0.0
20059440;286028;8;12.12.2023 00:00;11000;10140;860;1.1
20059458;273133;8;12.12.2023 00:00;117435;71060;46375;6.4
20059459;275320;8;13.12.2023 00:00;130730;106590;24140;10.2
20059556;274268;8;14.12.2023 00:00;246932;213179;33753;19.1
20059457;;8;15.12.2023 00:00;0;0;0;0.0
20059377;283328;8;15.12.2023 00:00;77590;63360;14230;6.7
20059367;285028;8;16.12.2023 00:00;88910;73656;15254;6.3
20059380;285776;8;16.12.2023 00:00;21300;20856;444;2.0
20059378;284796;8;16.12.2023 00:00;47010;41184;5826;3.9
20059379;285722;8;16.12.2023 00:00;11200;10296;904;1.1
20059368;285084;8;17.12.2023 00:00;31030;22176;8854;2.2
20059361;;8;17.12.2023 00:00;0;0;0;0.0
20059365;276802;8;17.12.2023 00:00;70953;57354;13599;5.6
20059366;277066;8;17.12.2023 00:00;76937;62304;14633;6.9
20059359;;8;18.12.2023 00:00;0;0;0;0.0
20059545;285150;8;18.12.2023 00:00;268317;235952;32365;18.5
20059547;286053;8;19.12.2023 00:00;121467;107252;14215;8.4
20059784;283979;8;20.12.2023 00:00;119602;107252;12350;8.0
20059783;283167;8;20.12.2023 00:00;139780;128700;11080;9.8
20059685;285011;8;21.12.2023 00:00;445801;403920;41881;38.6
20059737;282714;8;23.12.2023 00:00;296928;276900;20028;26.9
20060212;286269;8;10.01.2024 00:00;4000;3900;100;0.5
20060046;255011;8;10.01.2024 00:00;48984;26130;22854;4.1
20060214;286270;8;10.01.2024 00:00;4681;4681;0;2.1
20060103;286263;8;11.01.2024 00:00;2;2;0;0.0
20060144;283167;8;11.01.2024 00:00;124800;107250;17550;7.8
20060145;285050;8;12.01.2024 00:00;223660;214500;9160;16.1
20060246;283042;8;12.01.2024 00:00;702170;622054;80116;47.2
20060143;282953;8;17.01.2024 00:00;116993;107250;9743;7.9
20060142;276810;8;18.01.2024 00:00;120250;107250;13000;8.3
20060810;280920;8;19.01.2024 00:00;233620;214500;19120;16.0
20060593;286263;8;19.01.2024 00:00;3;3;0;3.3
20060641;285095;8;19.01.2024 00:00;68240;64350;3890;4.9
20060247;285149;8;20.01.2024 00:00;196410;171600;24810;12.8
20060248;285150;8;22.01.2024 00:00;321136;300300;20836;22.7
20060447;;8;23.01.2024 00:00;0;0;0;0.0
20060446;285880;8;23.01.2024 00:00;93294;71280;22014;6.8
20060440;283701;8;24.01.2024 00:00;141522;130948;10574;11.4
20060444;285867;8;24.01.2024 00:00;19628;10560;9068;1.4
20060443;285253;8;25.01.2024 00:00;28320;12672;15648;1.8
20060441;284375;8;25.01.2024 00:00;44660;41184;3476;3.6
20060445;285870;8;25.01.2024 00:00;15394;10561;4833;1.2
20060592;285861;8;25.01.2024 00:00;100234;95040;5194;8.0
20060589;245081;8;26.01.2024 00:00;33012;27456;5556;2.7
20060596;277066;8;26.01.2024 00:00;89900;83424;6476;7.5
20060449;;8;26.01.2024 00:00;0;0;0;0.0
20060590;277052;8;27.01.2024 00:00;58292;35640;22652;4.1
20060584;201695;8;29.01.2024 00:00;122758;82368;40390;10.8
20060172;286268;8;29.01.2024 00:00;5280;5280;0;1.0
20060788;268068;8;30.01.2024 00:00;22200;13728;8472;1.2
20060588;221392;8;30.01.2024 00:00;21602;16370;5232;2.0
20060787;268067;8;30.01.2024 00:00;33000;21120;11880;2.0
20060786;268066;8;30.01.2024 00:00;150915;126720;24195;11.2
20060454;;8;31.01.2024 00:00;0;0;0;0.0
20060882;285141;8;31.01.2024 00:00;157648;126360;31288;10.4
20060881;;8;01.02.2024 00:00;0;0;0;0.0
20061122;285050;8;01.02.2024 00:00;134911;107252;27659;8.2
20061121;283938;8;02.02.2024 00:00;121844;107250;14594;8.3
20060784;282953;8;03.02.2024 00:00;117480;107250;10230;8.1
20060973;280920;8;03.02.2024 00:00;216690;193050;23640;15.2
20060893;286053;8;04.02.2024 00:00;239970;214500;25470;16.3
20061080;285921;8;05.02.2024 00:00;199480;171510;27970;13.2
20060785;285150;8;06.02.2024 00:00;344265;321750;22515;23.7
20060961;285922;8;07.02.2024 00:00;362564;343200;19364;25.0
20061079;285663;8;08.02.2024 00:00;114120;107250;6870;8.4
20060974;285095;8;09.02.2024 00:00;104350;85800;18550;6.6
20060651;285095;8;09.02.2024 00:00;335170;321750;13420;23.4
20061216;285095;8;10.02.2024 00:00;153070;150150;2920;10.8
20061609;285095;8;11.02.2024 00:00;71100;64350;6750;4.6
20060892;285150;8;11.02.2024 00:00;180320;171600;8720;12.6
20061271;280920;8;12.02.2024 00:00;289310;278850;10460;20.1
20061272;286053;8;12.02.2024 00:00;138570;128700;9870;9.1
20061486;276810;8;13.02.2024 00:00;243400;235950;7450;17.4
20061487;276810;8;14.02.2024 00:00;188592;171602;16990;12.6
20061734;280895;8;15.02.2024 00:00;112350;107250;5100;8.2
20061426;285922;8;16.02.2024 00:00;495660;450450;45210;32.8
20061610;285922;8;17.02.2024 00:00;117210;107250;9960;8.4
20061873;271621;8;17.02.2024 00:00;154931;120510;34421;11.8
20061735;285095;8;18.02.2024 00:00;153346;134551;18795;9.6
20061874;285551;8;19.02.2024 00:00;47132;25191;21941;3.7
20061864;277469;8;20.02.2024 00:00;324098;299744;24354;28.7
20061862;273267;8;21.02.2024 00:00;116335;100740;15595;9.4
20061868;283084;8;21.02.2024 00:00;27002;25842;1160;2.4
20061939;281420;8;22.02.2024 00:00;50691;37443;13248;3.5
20061942;281926;8;22.02.2024 00:00;148850;131040;17810;13.6
20061947;282401;8;23.02.2024 00:00;75210;70200;5010;6.4
20061951;284219;8;24.02.2024 00:00;54612;50702;3910;4.9
20061950;284219;8;24.02.2024 00:00;27500;27690;-190;2.6
20061937;279703;8;24.02.2024 00:00;42900;36660;6240;3.5
20061938;280716;8;24.02.2024 00:00;74990;67080;7910;6.2
20061949;284188;8;24.02.2024 00:00;122550;118950;3600;10.8
20061945;282196;8;25.02.2024 00:00;44400;40560;3840;3.8
20061940;281565;8;25.02.2024 00:00;11820;10920;900;1.1
20061946;282197;8;25.02.2024 00:00;16200;14820;1380;1.4
20061941;281652;8;25.02.2024 00:00;15215;13260;1955;1.2
20061943;282031;8;25.02.2024 00:00;17500;13650;3850;1.4
20061948;284071;8;26.02.2024 00:00;19200;17160;2040;1.7
20062182;286248;8;26.02.2024 00:00;12500;10920;1580;1.0
20061978;282663;8;26.02.2024 00:00;12500;10920;1580;1.0
20061972;279702;8;26.02.2024 00:00;32640;31200;1440;2.8
20061971;277234;8;26.02.2024 00:00;12046;10921;1125;1.0
20061974;279879;8;26.02.2024 00:00;69620;65520;4100;6.0
20061970;276848;8;26.02.2024 00:00;24950;22620;2330;2.1
20061975;281831;8;26.02.2024 00:00;159200;149760;9440;13.5
20061944;282195;8;27.02.2024 00:00;13565;10140;3425;0.9
20061973;279780;8;27.02.2024 00:00;15240;14430;810;1.3
20062674;284800;8;27.02.2024 00:00;14380;12480;1900;1.2
20061981;286028;8;27.02.2024 00:00;12300;10920;1380;1.1
20062172;279605;8;27.02.2024 00:00;5072;5072;0;3.8
20061979;284959;8;27.02.2024 00:00;14395;10920;3475;1.1
20062173;279606;8;28.02.2024 00:00;2342;5072;-2730;1.0
20062179;285877;8;29.02.2024 00:00;64072;41976;22096;4.9
20062170;;8;29.02.2024 00:00;0;0;0;0.0
20062175;284796;8;29.02.2024 00:00;33202;21123;12079;2.2
20062177;285865;8;29.02.2024 00:00;45139;30624;14515;3.3
20062178;285866;8;01.03.2024 00:00;77961;69168;8793;6.8
20062181;285885;8;01.03.2024 00:00;51100;38017;13083;3.6
20062180;285884;8;01.03.2024 00:00;37250;30624;6626;3.0
20062176;285026;8;02.03.2024 00:00;74650;70752;3898;6.7
20062174;282400;8;02.03.2024 00:00;35200;22176;13024;2.5
20062350;281655;8;02.03.2024 00:00;9692;10560;-868;1.4
20062351;282200;8;02.03.2024 00:00;27500;24288;3212;2.4
20062515;;8;03.03.2024 00:00;0;0;0;0.0
20062517;284874;8;03.03.2024 00:00;265598;232320;33278;20.3
20062516;268066;8;04.03.2024 00:00;149342;137280;12062;12.5
20062171;;8;05.03.2024 00:00;0;0;0;0.0
20062744;276810;8;05.03.2024 00:00;133996;107250;26746;8.6
20062352;283920;8;05.03.2024 00:00;130201;107250;22951;8.4
20062521;283575;8;06.03.2024 00:00;123960;107250;16710;9.2
20062519;283165;8;07.03.2024 00:00;111595;107250;4345;8.0
20062745;283165;8;07.03.2024 00:00;302785;278850;23935;20.7
20062520;283167;8;08.03.2024 00:00;118360;107250;11110;7.7
20062522;285050;8;09.03.2024 00:00;136380;128700;7680;9.3
20062747;286905;8;11.03.2024 00:00;411180;386100;25080;28.5
20063287;286987;8;12.03.2024 00:00;49440;49440;0;4.0
20063110;286905;8;12.03.2024 00:00;296470;278850;17620;20.5
20062544;280920;8;13.03.2024 00:00;474271;450452;23819;32.5
20062746;285150;8;15.03.2024 00:00;369035;343200;25835;24.7
20063107;285150;8;16.03.2024 00:00;310898;278850;32048;20.6
20063460;285149;8;19.03.2024 00:00;113380;107250;6130;7.7
20063467;285922;8;19.03.2024 00:00;257372;235952;21420;17.4
20063109;285921;8;20.03.2024 00:00;115223;107250;7973;7.9
20063392;;8;20.03.2024 00:00;0;0;0;0.0
20063457;284579;8;21.03.2024 00:00;28200;20856;7344;2.4
20063458;284579;8;21.03.2024 00:00;44757;41184;3573;3.8
20063465;285871;8;22.03.2024 00:00;22219;15841;6378;1.5
20063468;286624;8;22.03.2024 00:00;24970;21120;3850;1.8
20063456;283701;8;22.03.2024 00:00;108920;95040;13880;8.4
20063463;285868;8;23.03.2024 00:00;10868;10560;308;1.0
20063461;285722;8;23.03.2024 00:00;12120;10032;2088;1.1
20063466;285883;8;25.03.2024 00:00;87350;79200;8150;6.6
20063462;285776;8;25.03.2024 00:00;14000;11088;2912;1.2
20063393;;8;25.03.2024 00:00;0;0;0;0.0
20063455;277052;8;25.03.2024 00:00;74200;50688;23512;5.9
20063452;210305;8;26.03.2024 00:00;119102;110619;8483;11.3
20063453;268067;8;26.03.2024 00:00;27200;10561;16639;1.4
20063454;268067;8;27.03.2024 00:00;32569;31680;889;2.9
20063469;285321;8;27.03.2024 00:00;66554;46464;20090;4.0
20063735;286982;8;28.03.2024 00:00;410418;333170;77248;29.3
20063733;286982;8;03.04.2024 00:00;358852;332640;26212;26.0
20063734;286982;8;04.04.2024 00:00;352770;332640;20130;26.9
20063830;286982;8;05.04.2024 00:00;363001;332114;30887;26.5
20064403;287078;8;09.04.2024 00:00;19272;19272;0;3.5
20064404;287080;8;09.04.2024 00:00;24260;24260;0;4.5
20063831;;8;09.04.2024 00:00;0;0;0;0.0
20063954;280895;8;09.04.2024 00:00;416694;364650;52044;26.4
20063832;286053;8;11.04.2024 00:00;232186;214500;17686;15.8
20063976;287135;8;12.04.2024 00:00;287091;257400;29691;20.5
20063977;287135;8;13.04.2024 00:00;351961;321752;30209;24.2
20064514;287135;8;14.04.2024 00:00;116600;107250;9350;8.1
20063974;283042;8;14.04.2024 00:00;328000;300300;27700;21.8
20064291;283575;8;16.04.2024 00:00;452737;429000;23737;31.9
20064292;284322;8;16.04.2024 00:00;69000;64350;4650;4.5
20063861;287028;8;17.04.2024 00:00;251450;235950;15500;17.6
20063957;287027;8;18.04.2024 00:00;116552;107252;9300;8.0
20063956;283165;8;19.04.2024 00:00;115957;107250;8707;7.8
20063975;283165;8;20.04.2024 00:00;114126;107250;6876;8.1
20063958;287115;8;21.04.2024 00:00;271390;257400;13990;19.2
20064459;285149;8;21.04.2024 00:00;192050;171600;20450;13.0
20064598;286053;8;22.04.2024 00:00;185700;171600;14100;13.0
20064599;287236;8;23.04.2024 00:00;771495;729300;42195;53.1
20064600;287236;8;25.04.2024 00:00;764001;729300;34701;52.3
20064912;287343;8;28.04.2024 00:00;231677;218400;13277;16.2
20064031;285826;8;29.04.2024 00:00;11360;11360;0;6.1
20063955;282953;8;29.04.2024 00:00;182141;171600;10541;12.4
20064289;282953;8;30.04.2024 00:00;117190;107250;9940;7.7
20064646;280895;8;30.04.2024 00:00;69791;64351;5440;4.7
20064735;280895;8;30.04.2024 00:00;574500;536250;38250;39.3
20064851;287135;8;02.05.2024 00:00;95850;107250;-11400;7.1
20065276;287135;8;03.05.2024 00:00;119100;107250;11850;7.4
20065056;285800;8;03.05.2024 00:00;239500;235950;3550;17.2
20065256;286053;8;04.05.2024 00:00;120216;107250;12966;7.8
20065255;283165;8;04.05.2024 00:00;113150;107250;5900;8.0
20064290;283165;8;05.05.2024 00:00;110970;107250;3720;7.6
20065055;285439;8;05.05.2024 00:00;50340;28080;22260;3.2
20065060;;8;05.05.2024 00:00;0;0;0;0.0
20065050;221764;8;06.05.2024 00:00;57300;41341;15959;4.0
20065058;;8;06.05.2024 00:00;0;0;0;0.0
20065052;268066;8;06.05.2024 00:00;168570;107712;60858;10.8
20065061;;8;08.05.2024 00:00;0;0;0;0.0
20065053;268068;8;08.05.2024 00:00;20769;13728;7041;1.4
20065063;284375;8;08.05.2024 00:00;63630;47256;16374;4.3
20065064;284796;8;08.05.2024 00:00;59600;50688;8912;4.3
20065057;286624;8;09.05.2024 00:00;11600;10560;1040;1.0
20065065;285776;8;09.05.2024 00:00;35110;23232;11878;2.1
20065051;224109;8;09.05.2024 00:00;34359;22176;12183;2.6
20065059;;8;10.05.2024 00:00;0;0;0;0.0
20065415;285800;8;10.05.2024 00:00;441945;407550;34395;29.6
20065417;287398;8;11.05.2024 00:00;117500;107250;10250;7.9
20065494;280895;8;12.05.2024 00:00;249100;235950;13150;16.9
20065416;287028;8;13.05.2024 00:00;240000;235950;4050;17.2
20065413;283165;8;13.05.2024 00:00;108200;107251;949;7.8
20065414;283165;8;14.05.2024 00:00;110035;107250;2785;7.8
20065554;287502;8;14.05.2024 00:00;200750;193050;7700;14.0
20065476;287399;8;15.05.2024 00:00;299395;278850;20545;20.3
20065695;275509;8;16.05.2024 00:00;0;0;0;0.0
20065698;287560;8;16.05.2024 00:00;113100;109200;3900;8.7
20065696;287343;8;16.05.2024 00:00;118520;109200;9320;8.3
20065697;287558;8;17.05.2024 00:00;122736;109200;13536;8.1
20065553;286053;8;17.05.2024 00:00;571264;536250;35014;39.0
20065859;285149;8;19.05.2024 00:00;113800;107250;6550;8.1
20065690;287236;8;19.05.2024 00:00;380299;364650;15649;26.8
20065857;283042;8;21.05.2024 00:00;462531;429000;33531;30.8
20065858;283042;8;22.05.2024 00:00;469869;450450;19419;32.6
20066080;283165;8;24.05.2024 00:00;103600;107250;-3650;7.6
20066082;287028;8;24.05.2024 00:00;336040;321750;14290;23.7
20066081;287027;8;26.05.2024 00:00;113060;107250;5810;7.7
20066084;287502;8;26.05.2024 00:00;530745;493350;37395;35.8
20066083;287502;8;28.05.2024 00:00;481995;471900;10095;33.8
20066085;287722;8;29.05.2024 00:00;113650;107250;6400;7.9
20066028;287501;8;30.05.2024 00:00;114450;107250;7200;8.1
20066086;287501;8;30.05.2024 00:00;110600;107250;3350;7.9
20066635;287501;8;31.05.2024 00:00;496505;471900;24605;34.3
20066634;287501;8;01.06.2024 00:00;472150;450450;21700;32.3
20065944;287135;8;03.06.2024 00:00;449350;429000;20350;31.0
20065689;287135;8;04.06.2024 00:00;176452;176282;170;12.3
20066144;287135;8;05.06.2024 00:00;115600;107250;8350;8.0
20066145;287135;8;05.06.2024 00:00;113300;107250;6050;7.9
20065945;287407;8;06.06.2024 00:00;167150;150150;17000;10.9
20065967;287407;8;06.06.2024 00:00;500450;493350;7100;35.0
20066767;282953;8;08.06.2024 00:00;111502;107252;4250;7.7
20066928;283924;8;08.06.2024 00:00;203000;193050;9950;13.9
20066623;287115;8;09.06.2024 00:00;374232;343202;31030;24.9
20066930;287028;8;10.06.2024 00:00;263467;257400;6067;18.6
20067004;287502;8;11.06.2024 00:00;455200;429000;26200;30.8
20066529;283165;8;13.06.2024 00:00;111750;107250;4500;7.8
20066927;283165;8;13.06.2024 00:00;135700;128700;7000;8.9
20067232;287985;8;14.06.2024 00:00;13153;13153;0;3.5
20066806;285826;8;14.06.2024 00:00;7250;7250;0;5.0
20066360;;8;14.06.2024 00:00;0;0;0;0.0
20066361;256213;8;14.06.2024 00:00;54995;26520;28475;2.9
20066362;;8;15.06.2024 00:00;0;0;0;0.0
20066416;253777;8;15.06.2024 00:00;26950;13729;13221;2.0
20066421;268068;8;15.06.2024 00:00;19500;13728;5772;1.4
20066418;268066;8;15.06.2024 00:00;141300;126720;14580;12.4
20066420;268067;8;15.06.2024 00:00;28870;21120;7750;2.0
20066419;268066;8;16.06.2024 00:00;134202;126722;7480;11.9
20067189;281303;8;17.06.2024 00:00;101989;87386;14603;8.2
20067240;287986;8;18.06.2024 00:00;23724;23724;0;10.8
20066554;;8;18.06.2024 00:00;0;0;0;0.0
20066423;285861;8;18.06.2024 00:00;93572;76034;17538;6.6
20066424;285871;8;19.06.2024 00:00;19750;12673;7077;1.2
20066426;;8;19.06.2024 00:00;0;0;0;0.0
20066526;287806;8;19.06.2024 00:00;2789;2789;0;1.6
20066528;;8;19.06.2024 00:00;0;0;0;0.0
20066769;284376;8;19.06.2024 00:00;13079;10032;3047;1.0
20066929;287027;8;19.06.2024 00:00;124507;107250;17257;8.9
20067001;283575;8;20.06.2024 00:00;440600;407550;33050;30.0
20067002;283575;8;21.06.2024 00:00;435600;407550;28050;29.5
20067675;283575;8;25.06.2024 00:00;135460;128700;6760;9.4
20067003;285663;8;26.06.2024 00:00;115710;107250;8460;8.2
20067678;287387;8;26.06.2024 00:00;360740;343200;17540;25.1
20067677;287135;8;27.06.2024 00:00;141550;128700;12850;9.2
20068007;287135;8;28.06.2024 00:00;261701;235950;25751;17.7
20067676;285800;8;01.07.2024 00:00;256064;235952;20112;17.6
20067679;287407;8;03.07.2024 00:00;84000;85800;-1800;6.0
20067680;287407;8;03.07.2024 00:00;114700;107250;7450;7.8
20067681;287407;8;03.07.2024 00:00;516632;492572;24060;35.7
20068010;287915;8;05.07.2024 00:00;15800;10140;5660;0.9
20067998;274759;8;05.07.2024 00:00;192763;175500;17263;16.4
20067999;281112;8;08.07.2024 00:00;53166;42120;11046;4.2
20068000;283084;8;08.07.2024 00:00;61264;50388;10876;4.8
20067979;;8;09.07.2024 00:00;0;0;0;0.0
20068001;284375;8;09.07.2024 00:00;58123;57027;1096;4.7
20068002;284376;8;09.07.2024 00:00;38300;24288;14012;2.0
20068004;284875;8;10.07.2024 00:00;34000;31680;2320;3.0
20068005;284876;8;10.07.2024 00:00;14500;13728;772;1.5
20068034;;8;10.07.2024 00:00;0;0;0;0.0
20068006;284876;8;10.07.2024 00:00;27177;13730;13447;1.3
20068003;284875;8;10.07.2024 00:00;32502;31682;820;3.3
20068180;;8;10.07.2024 00:00;0;0;0;0.0
20068517;287502;8;10.07.2024 00:00;576435;514800;61635;39.4
20069119;284322;8;29.07.2024 00:00;189800;171600;18200;12.7
20068680;287501;8;30.07.2024 00:00;541711;514800;26911;36.9
20068681;287387;8;01.08.2024 00:00;116870;107250;9620;8.4
20068644;288452;8;01.08.2024 00:00;190600;171600;19000;12.7
20068643;288449;8;02.08.2024 00:00;430180;407550;22630;30.0
20068989;287501;8;04.08.2024 00:00;544830;514800;30030;37.4
20068682;287398;8;05.08.2024 00:00;113670;107250;6420;7.4
20069330;287398;8;06.08.2024 00:00;132250;128700;3550;9.4
20069122;288523;8;06.08.2024 00:00;183550;171600;11950;12.7
20069524;285800;8;07.08.2024 00:00;255200;235950;19250;17.3
20069527;287407;8;08.08.2024 00:00;223402;214502;8900;15.5
20068408;283165;8;09.08.2024 00:00;290750;278850;11900;20.0
20069118;283165;8;10.08.2024 00:00;108890;107250;1640;7.5
20069121;287502;8;10.08.2024 00:00;140180;128700;11480;9.2
20069592;287502;8;11.08.2024 00:00;104645;107250;-2605;7.6
20069331;287236;8;11.08.2024 00:00;588660;557700;30960;40.1
20069817;288449;8;13.08.2024 00:00;378360;364650;13710;26.3
20069525;286053;8;14.08.2024 00:00;110370;107250;3120;7.7
20069602;286624;8;15.08.2024 00:00;17814;10560;7254;1.1
20069123;;8;15.08.2024 00:00;0;0;0;0.0
20069599;285871;8;15.08.2024 00:00;22002;21120;882;1.6
20069594;285681;8;15.08.2024 00:00;13680;10560;3120;1.1
20069593;283701;8;15.08.2024 00:00;145800;131670;14130;11.5
20069598;285870;8;15.08.2024 00:00;11800;10560;1240;0.9
20069595;285722;8;16.08.2024 00:00;10002;10563;-561;0.9
20069596;285865;8;16.08.2024 00:00;24999;18744;6255;1.6
20069597;285866;8;16.08.2024 00:00;23000;17952;5048;1.5
20069601;285885;8;17.08.2024 00:00;19034;13464;5570;1.5
20069600;285884;8;17.08.2024 00:00;28234;28776;-542;2.5
20069125;;8;17.08.2024 00:00;0;0;0;0.0
20070088;286745;8;17.08.2024 00:00;24844;14785;10059;1.2
20069603;268067;8;17.08.2024 00:00;35300;21120;14180;1.9
20069604;284874;8;18.08.2024 00:00;250468;232320;18148;22.9
20069124;;8;19.08.2024 00:00;0;0;0;0.0
20069720;288326;8;19.08.2024 00:00;22447;17160;5287;1.9
20069713;279702;8;19.08.2024 00:00;37300;28860;8440;2.6
20069719;288066;8;19.08.2024 00:00;18400;10920;7480;1.2
20069714;279879;8;19.08.2024 00:00;39050;35880;3170;3.4
20069716;281831;8;20.08.2024 00:00;196550;182520;14030;17.0
20069718;284219;8;20.08.2024 00:00;22460;10920;11540;1.1
20069722;287353;8;20.08.2024 00:00;11500;10530;970;1.1
20070159;288739;8;21.08.2024 00:00;6240;6240;0;5.0
20069715;280716;8;21.08.2024 00:00;22740;24960;-2220;2.3
20069717;281926;8;21.08.2024 00:00;68530;50702;17828;5.6
20069721;288327;8;21.08.2024 00:00;52530;44460;8070;4.5
20069816;283575;8;22.08.2024 00:00;358644;321750;36894;22.9
20069526;286053;8;23.08.2024 00:00;113200;107250;5950;8.0
20070144;287398;8;23.08.2024 00:00;163034;150150;12884;11.1
20070142;285800;8;24.08.2024 00:00;113966;107250;6716;8.4
20070147;288330;8;24.08.2024 00:00;117000;107250;9750;8.1
20070143;287135;8;25.08.2024 00:00;305800;278850;26950;20.5
20069981;287236;8;26.08.2024 00:00;165000;150150;14850;10.7
20069982;288644;8;26.08.2024 00:00;680100;643500;36600;46.4
20070064;288644;8;28.08.2024 00:00;494983;471900;23083;34.8
20070065;288644;8;30.08.2024 00:00;507770;471900;35870;34.5
20070287;288644;8;01.09.2024 00:00;497278;471904;25374;34.5
20070392;288644;8;02.09.2024 00:00;117840;107250;10590;8.3
20070397;288645;8;03.09.2024 00:00;499313;471902;27411;35.2
20070415;;8;05.09.2024 00:00;0;0;0;0.0
20070419;278853;8;05.09.2024 00:00;38935;26523;12412;3.1
20070417;221764;8;05.09.2024 00:00;44612;26522;18090;2.9
20070413;;8;06.09.2024 00:00;0;0;0;0.0
20070418;221764;8;06.09.2024 00:00;27633;26522;1111;3.4
20070474;280634;8;06.09.2024 00:00;47303;15581;31722;2.3
20070475;281264;8;07.09.2024 00:00;16719;15842;877;1.8
20070472;268066;8;07.09.2024 00:00;148101;126460;21641;14.2
20070416;;8;08.09.2024 00:00;0;0;0;0.0
20070654;253777;8;08.09.2024 00:00;15502;13730;1772;1.5
20070473;272023;8;08.09.2024 00:00;34505;24816;9689;2.9
20070555;285877;8;08.09.2024 00:00;39595;29568;10027;2.8
20070559;287594;8;09.09.2024 00:00;31502;31418;84;2.8
20070558;287593;8;09.09.2024 00:00;30200;24816;5384;2.6
20070557;287589;8;09.09.2024 00:00;48700;35904;12796;3.2
20070556;287588;8;10.09.2024 00:00;39400;35904;3496;3.6
20070554;285861;8;10.09.2024 00:00;59802;57026;2776;4.9
20070414;;8;11.09.2024 00:00;0;0;0;0.0
20070551;285800;8;11.09.2024 00:00;126030;107250;18780;8.8
20070650;285800;8;11.09.2024 00:00;136772;140792;-4020;9.9
20070552;287501;8;12.09.2024 00:00;627760;579150;48610;44.9
20070651;288452;8;15.09.2024 00:00;177940;171600;6340;12.4
20070652;288644;8;15.09.2024 00:00;728400;686400;42000;49.6
20070700;288644;8;18.09.2024 00:00;112770;107250;5520;7.9
20071233;288645;8;18.09.2024 00:00;226524;214502;12022;16.2
20070553;271621;8;20.09.2024 00:00;193035;172380;20655;13.4
20070901;273267;8;21.09.2024 00:00;117310;98325;18985;9.0
20070998;281926;8;23.09.2024 00:00;135920;120900;15020;11.5
20071053;281419;8;24.09.2024 00:00;27050;20280;6770;2.1
20071060;283838;8;24.09.2024 00:00;12785;10530;2255;1.0
20071062;286248;8;24.09.2024 00:00;14100;10920;3180;1.0
20071057;282196;8;24.09.2024 00:00;12600;10920;1680;1.1
20071055;281565;8;24.09.2024 00:00;11400;10920;480;1.1
20071061;284071;8;24.09.2024 00:00;15900;14040;1860;1.5
20071059;283332;8;25.09.2024 00:00;14000;10920;3080;1.2
20071063;288325;8;25.09.2024 00:00;30002;27692;2310;3.0
20071052;279703;8;25.09.2024 00:00;53570;41340;12230;4.4
20071121;276848;8;25.09.2024 00:00;36058;31200;4858;3.2
20071058;282663;8;25.09.2024 00:00;38430;35100;3330;3.3
20071122;279702;8;25.09.2024 00:00;22810;20280;2530;2.0
20071054;281420;8;26.09.2024 00:00;36923;25351;11572;2.4
20071056;281831;8;26.09.2024 00:00;11800;10920;880;1.0
20071125;287380;8;26.09.2024 00:00;17000;10920;6080;1.2
20071224;281112;8;26.09.2024 00:00;51053;43680;7373;4.4
20070902;282720;8;26.09.2024 00:00;60768;51480;9288;5.0
20071509;289000;8;27.09.2024 00:00;50225;40056;10169;3.7
20071510;289003;8;27.09.2024 00:00;46957;40052;6905;3.7
20071528;288330;8;27.09.2024 00:00;125602;115832;9770;8.6
20070701;288644;8;28.09.2024 00:00;636422;579152;57270;42.4
20071065;;8;30.09.2024 00:00;0;0;0;0.0
20071227;268067;8;30.09.2024 00:00;33801;21121;12680;2.3
20071232;286745;8;01.10.2024 00:00;41590;27456;14134;2.4
20071228;281262;8;01.10.2024 00:00;81620;71808;9812;5.6
20071543;287986;8;02.10.2024 00:00;27515;27515;0;15.3
20071231;284376;8;02.10.2024 00:00;39200;31680;7520;2.6
20071246;;8;02.10.2024 00:00;0;0;0;0.0
20071230;283701;8;02.10.2024 00:00;144720;130417;14303;10.4
20071419;285776;8;03.10.2024 00:00;13781;13728;53;1.2
20071244;;8;03.10.2024 00:00;0;0;0;0.0
20070851;283165;8;03.10.2024 00:00;158310;128700;29610;9.9
20071229;283165;8;04.10.2024 00:00;114700;107250;7450;7.6
20072149;283165;8;04.10.2024 00:00;140250;128700;11550;10.2
20071312;288644;8;05.10.2024 00:00;343300;321750;21550;24.0
20071485;288644;8;06.10.2024 00:00;225150;214500;10650;15.2
20072147;282953;8;07.10.2024 00:00;229426;214500;14926;15.9
20071707;287343;8;08.10.2024 00:00;120100;109201;10899;7.9
20071777;287558;8;08.10.2024 00:00;641750;592800;48950;43.3
20071776;287135;8;11.10.2024 00:00;109762;107252;2510;7.6
20071420;287407;8;11.10.2024 00:00;413163;386102;27061;27.9
20071527;287407;8;15.10.2024 00:00;113750;107250;6500;7.7
20071986;288523;8;16.10.2024 00:00;210230;193050;17180;14.8
20071708;287387;8;16.10.2024 00:00;228473;214502;13971;16.4
20072511;287387;8;17.10.2024 00:00;246080;235950;10130;17.3
20072512;287501;8;18.10.2024 00:00;371920;343200;28720;26.1
20071709;288644;8;19.10.2024 00:00;387825;343592;44233;25.8
20071987;288644;8;20.10.2024 00:00;183500;171600;11900;12.4
20072148;286053;8;21.10.2024 00:00;536950;514800;22150;37.4
20072559;286053;8;23.10.2024 00:00;225090;235952;-10862;16.2
20072645;289188;8;24.10.2024 00:00;28468;28468;0;5.4
20072643;;8;24.10.2024 00:00;0;0;0;0.0
20072401;;8;24.10.2024 00:00;0;0;0;0.0
20072469;268068;8;24.10.2024 00:00;25300;13728;11572;1.5
20072468;268066;8;24.10.2024 00:00;151475;126720;24755;11.4
20072470;274932;8;25.10.2024 00:00;32327;25347;6980;2.4
20072403;;8;25.10.2024 00:00;0;0;0;0.0
20072473;285885;8;26.10.2024 00:00;41359;31947;9412;3.0
20072476;289092;8;26.10.2024 00:00;49627;38019;11608;3.4
20072471;282200;8;26.10.2024 00:00;55400;50952;4448;5.4
20072402;;8;27.10.2024 00:00;0;0;0;0.0
20072799;289172;8;27.10.2024 00:00;803560;729300;74260;56.5
20072560;287501;8;01.11.2024 00:00;137605;128700;8905;9.9
20072558;285800;8;01.11.2024 00:00;115135;107250;7885;7.8
20072797;288449;8;01.11.2024 00:00;187377;171602;15775;12.7
20072796;288214;8;02.11.2024 00:00;363022;356462;6560;25.3
20073003;289195;8;03.11.2024 00:00;181154;171601;9553;12.4
20071983;287115;8;04.11.2024 00:00;181973;171604;10369;12.1
20072301;283165;8;05.11.2024 00:00;180669;171602;9067;13.0
20072952;289076;8;05.11.2024 00:00;16756;10921;5835;1.1
20072954;289055;8;07.11.2024 00:00;10660;10660;0;4.4
20072951;288795;8;08.11.2024 00:00;114942;105302;9640;10.2
20073266;288535;8;08.11.2024 00:00;248960;226100;22860;23.5
20072953;281112;8;09.11.2024 00:00;50612;41342;9270;4.1
20072949;254369;8;10.11.2024 00:00;54348;44462;9886;4.3
20072950;273267;8;10.11.2024 00:00;128346;111455;16891;11.0
20072303;287027;8;11.11.2024 00:00;127209;107250;19959;8.2
20072302;283575;8;11.11.2024 00:00;115150;107250;7900;8.2
20072557;283575;8;12.11.2024 00:00;111132;107252;3881;7.7
20072795;283165;8;12.11.2024 00:00;120559;107252;13307;8.2
20072798;288645;8;14.11.2024 00:00;126854;107252;19602;8.4
20073672;288214;8;15.11.2024 00:00;369586;343202;26384;25.9
20073245;288452;8;16.11.2024 00:00;317738;291330;26408;21.4
